border_size=1
usage=map

Qxua^Xo, Qxua^Xo, Qxua^Xo, Qxua, Qxua^Xo, Qxua^Xo, Qxua^Xo, Qxua^Xo, Qxua^Xo, Qxua^Xo, Qxua^Xo, Qxua^Xo, Qxua^Xo, Qxua^Xo, Qxua^Xo, Qxua^Xo, Qxua^Xo, Qxua^Xo, Qxua^Xo, Qxua^Xo, Qxua^Xo, Qxua^Xo, Qxua^Xo, Qxua^Xo, Qxua^Xo, Qxua^Xo, Qxua^Xo, Qxua^Xo, Qxua^Xo, Qxua^Xo, Qxua^Xo, Qxua^Xo, Qxua^Xo, Qxua^Xo, Qxua^Xo
Qxua^Xo, Qxua^Xo, Qxua^Xo, Qxua^Xo, Qxua^Xo, Qxua^Xo, Qxua^Xo, Qxua^Xo, Qxua^Xo, Qxua^Xo, Qxua^Xo, Qxua^Xo, Qxua^Xo, Qxua^Xo, Qxua^Xo, Qxua^Xo, Qxua^Xo, Qxua^Xo, Qxua^Xo, Qxua^Xo, Qxua^Xo, Qxua^Xo, Qxua^Xo, Qxua^Xo, Qxua^Xo, Qxua^Xo, Qxua^Xo, Qxua^Xo, Qxua^Xo, Qxua^Xo, Qxua^Xo, Qxua^Xo, Qxua^Xo, Qxua^Xo, Qxua^Xo
Qxua^Xo, Qxua^Xo, Qxua^Xo, Qxua^Xo, Qxua^Xo, Qxua^Xo, Qxua^Xo, Qxua^Xo, Qxua^Xo, Qxua^Xo, Aa, Aa, Aa, Aa, Aa, Aa^Es, Aa^Es, Aa^Es, Aa, Aa^Es, Aa^Es, Aa, Ms, Ms, Ms^Xm, Qxua^Xo, Qxua^Xo, Qxua^Xo, Qxua^Xo, Qxua^Xo, Qxua^Xo, Qxua^Xo, Qxua^Xo, Qxua^Xo, Qxua^Xo
Qxua^Xo, Qxua^Xo, Qxua^Xo, Qxua^Xo, Qxua^Xo, Qxua^Xo, Qxua^Xo, Chr, Chr, Wwg, Wwg^Bsb/, Rrc, Rrc, Aa, Rrc, Rrc, Rrc, Aa^Es, Rb, Rb, Rb, Rb, Rb, Ms, Aa, Ms^Xm, Ms^Xm, Qxua^Xo, Qxua^Xo, Qxua^Xo, Qxua^Xo, Qxua^Xo, Qxua^Xo, Qxua^Xo, Qxua^Xo
Qxua^Xo, Qxua^Xo, Qxua^Xo, Qxua^Xo, Khr, Qxua^Xo, Qxua^Xo, Wwg, Ai, 1 Kh, Wwg, Wwg, Aa^Vha, Rrc, Aa, Aa, Aa^Fpa, Rrc, Aa, Aa^Fpa, Aa^Fpa, Aa^Fpa, Aa^Fpa, Rb, Rb, Aa^Fpa, Aa^Fpa, Ms^Xm, Ms^Xm, Qxua^Xo, Qxua^Xo, Qxua^Xo, Qxua^Xo, Qxua^Xo, Qxua^Xo
Qxua^Xo, Qxua^Xo, Qxua^Xo, Qxua^Xo, Qxua^Xo, Qxua^Xo, Qxua^Xo, Wwg, Sm, Wwg, Sm, Ai, Ai, Aa, Aa, Aa, Rb, Rrc, Aa, Aa^Fpa, Aa^Fpa, Ms, Ms, Ha^Fpa, Ha^Fpa, Rb, Rb, Aa^Fpa, Ha, Ms^Xm, Qxua^Xo, Qxua^Xo, Qxua^Xo, Qxua^Xo, Qxua^Xo
Qxua^Xo, Qxua^Xo, Qxua^Xo, Qxua^Xo, Qxua^Xo, Qxua^Xo, Aa^Fpa, Sm, Aa^Fpa, Sm, Aa, Aa, Aa, Ai, Wwg^Bw/r, Rb, Aa, Rrc, Rrc, Aa, Ha, Ms, Ms, Ms, Ms, Aa^Fpa, Cea, Rb, Rb, Ms^Xm, Ms^Xm, Qxua^Xo, Qxua^Xo, Qxua^Xo, Qxua^Xo
Qxua^Xo, Qxua^Xo, Qxua^Xo, Qxua^Xo, Qxua^Xo, Aa^Fpa, Aa^Fpa, Aa^Fpa, Aa^Fpa, Aa^Fpa, Ms, Aa, Rb, Chr, Wog, Wog, Ai, Aa^Fpa, Aa, Rrc, Rb, Ha^Fpa, Ha^Fpa, Ms, Ms, Ha^Fpa, Ha, Kea, Aa^Fpa, Rb^Vhs, Ms^Xm, Qxua^Xo, Qxua^Xo, Qxua^Xo, Qxua^Xo
Qxua^Xo, Qxua^Xo, Qxua^Xo, Qxua^Xo, Qxua^Xo, Aa^Fpa, Aa^Fpa, Aa^Fpa, Aa^Fpa, Ms, Aa, Aa, Rb, Aa, Aa, Wog, Wog, Wog, Wog^Bsb/, Rrc, Aa, Rb, Ha^Fpa, Ms, Ms, Ha^Fpa, Rb, Rb, Aa, Ms^Xm, Qxua^Xo, Qxua^Xo, Qxua^Xo, Qxua^Xo, Qxua^Xo
Qxua^Xo, Qxua^Xo, Qxua^Xo, Qxua^Xo, Qxua^Xo, Aa^Fpa, Ms, Ms, Aa^Fpa, Aa^Fpa, Rb, Rb, Aa^Fpa, Rb, Sm, Ai, Aa^Vhc, Cha, Aa^Fda, Wog, Sm, Rb, Ha, Ms, Aa, Aa^Fpa, Rb, Aa^Fpa, Aa^Fpa, Ms^Xm, Qxua^Xo, Qxua^Xo, Qxua^Xo, Qxua^Xo, Qxua^Xo
Qxua^Xo, Qxua^Xo, Qxua^Xo, Qxua^Xo, Qxua^Xo, Ms^Xm, Aa^Fpa, Ms, Rb, Rb, Aa, Aa, Ha, Rb, Sm, Ai, Aa^Fda, Kha, Aa^Vhc, Ai, Sm, Rb, Aa^Fpa, Aa, Rb, Rb, Aa^Fpa, Ms, Ms, Ms^Xm, Qxua^Xo, Qxua^Xo, Qxua^Xo, Qxua^Xo, Qxua^Xo
Qxua^Xo, Qxua^Xo, Qxua^Xo, Qxua^Xo, Qxua^Xo, Ms^Xm, Aa, Aa^Fpa, Rb, Aa^Fpa, Ms, Ms, Ha^Fpa, Rb, Aa, Wog, Wog^Bsb/, Cha, Wog, Ai, Aa, Rb, Rb, Rb, Aa, Aa^Fpa, Aa^Fpa, Ms, Aa^Fpa, Aa^Fpa, Qxua^Xo, Qxua^Xo, Qxua^Xo, Qxua^Xo, Qxua^Xo
Qxua^Xo, Qxua^Xo, Qxua^Xo, Qxua^Xo, Ms^Xm, Ms^Xm, Aa^Fpa, Rb, Ha, Ha^Fpa, Ms, Ms, Ha^Fpa, Rb, Rb, Rrc, Aa, Wog, Ai, Wog, Wog, Aa, Rb, Aa, Ms, Ms, Aa^Fpa, Aa^Fpa, Aa^Fpa, Aa^Fpa, Qxua^Xo, Qxua^Xo, Qxua^Xo, Qxua^Xo, Qxua^Xo
Qxua^Xo, Qxua^Xo, Qxua^Xo, Qxua^Xo, Ms^Xm, Rb^Vd, Rb, Kea, Cea, Ha^Fpa, Ms, Ms, Ms, Ha^Fpa, Ha, Rrc, Rrc, Aa^Fpa, Aa, Wog, Wwg^Bw/r, Chr, Aa, Aa, Aa, Aa^Fpa, Aa^Fpa, Aa^Fpa, Aa^Fpa, Aa^Fpa, Qxua^Xo, Qxua^Xo, Qxua^Xo, Qxua^Xo, Qxua^Xo
Qxua^Xo, Qxua^Xo, Qxua^Xo, Qxua^Xo, Qxua^Xo, Ms^Xm, Ha, Rb, Rb, Aa^Fpa, Ha^Fpa, Ms, Ms, Ms, Aa^Fpa, Aa, Aa, Rrc, Rb, Rb, Aa, Ai, Ai, Aa, Sm, Sm, Sm, Sm, Qxua^Xo, Qxua^Xo, Qxua^Xo, Qxua^Xo, Qxua^Xo, Qxua^Xo, Qxua^Xo
Qxua^Xo, Qxua^Xo, Qxua^Xo, Qxua^Xo, Qxua^Xo, Ms^Xm, Ms^Xm, Aa^Fpa, Aa^Fpa, Rb, Rb, Ha^Fpa, Aa^Fpa, Ms, Aa^Fpa, Aa^Fpa, Aa, Rrc, Aa^Fpa, Aa, Aa, Aa, Aa^Vha, Ai, Wwg, Wwg, Ai, Wwg, Qxua^Xo, Qxua^Xo, Khr, Qxua^Xo, Qxua^Xo, Qxua^Xo, Qxua^Xo
Qxua^Xo, Qxua^Xo, Qxua^Xo, Qxua^Xo, Qxua^Xo, Qxua^Xo, Qxua^Xo, Ms^Xm, Ms^Xm, Aa^Fpa, Aa, Rb, Rb, Aa^Fpa, Rb, Aa^Fpa, Rb, Rrc, Rrc, Aa, Rrc, Rrc, Rrc, Wwg, Wwg^Bsb/, 2 Khr, Chr, Wwg, Qxua^Xo, Qxua^Xo, Qxua^Xo, Qxua^Xo, Qxua^Xo, Qxua^Xo, Qxua^Xo
Qxua^Xo, Qxua^Xo, Qxua^Xo, Qxua^Xo, Qxua^Xo, Qxua^Xo, Qxua^Xo, Qxua^Xo, Qxua^Xo, Ms^Xm, Ms^Xm, Ms, Ms, Rb, Aa, Rb, Aa, Aa^Es, Aa, Rrc, Aa, Aa, Aa, Rrc, Aa, Wwg, Qxua^Xo, Chr, Qxua^Xo, Qxua^Xo, Qxua^Xo, Qxua^Xo, Qxua^Xo, Qxua^Xo, Qxua^Xo
Qxua^Xo, Qxua^Xo, Qxua^Xo, Qxua^Xo, Qxua^Xo, Qxua^Xo, Qxua^Xo, Qxua^Xo, Qxua^Xo, Qxua^Xo, Qxua^Xo, Ms, Qxua^Xo, Aa^Es, Qxua^Xo, Aa^Es, Qxua^Xo, Aa^Es, Qxua^Xo, Aa^Es, Qxua^Xo, Aa, Qxua^Xo, Aa, Qxua^Xo, Qxua^Xo, Qxua^Xo, Qxua^Xo, Qxua^Xo, Qxua^Xo, Qxua^Xo, Qxua^Xo, Qxua^Xo, Qxua^Xo, Qxua^Xo
Qxua^Xo, Qxua^Xo, Qxua^Xo, Qxua^Xo, Qxua^Xo, Qxua^Xo, Qxua^Xo, Qxua^Xo, Qxua^Xo, Qxua^Xo, Qxua^Xo, Qxua^Xo, Qxua^Xo, Qxua^Xo, Qxua^Xo, Qxua^Xo, Qxua^Xo, Qxua^Xo, Qxua^Xo, Qxua^Xo, Qxua^Xo, Qxua^Xo, Qxua^Xo, Qxua^Xo, Qxua^Xo, Qxua^Xo, Qxua^Xo, Qxua^Xo, Qxua^Xo, Qxua^Xo, Qxua^Xo, Qxua^Xo, Qxua^Xo, Qxua^Xo, Qxua^Xo
Qxua^Xo, Qxua^Xo, Qxua^Xo, Qxua^Xo, Qxua^Xo, Qxua^Xo, Qxua^Xo, Qxua^Xo, Qxua^Xo, Qxua^Xo, Qxua^Xo, Qxua^Xo, Qxua^Xo, Qxua^Xo, Qxua^Xo, Qxua^Xo, Qxua^Xo, Qxua^Xo, Qxua^Xo, Qxua^Xo, Qxua^Xo, Qxua^Xo, Qxua^Xo, Qxua^Xo, Qxua^Xo, Qxua^Xo, Qxua^Xo, Qxua^Xo, Qxua^Xo, Qxua^Xo, Qxua^Xo, Qxua^Xo, Qxua^Xo, Qxua^Xo, Qxua^Xo
