border_size=1
usage=map

Qxua^Xo, Qxua^Xo, Qxua^Xo, Qxua^Xo, Qxua^Xo, Qxua^Xo, Qxua^Xo, Qxua^Xo, Qxua^Xo, Qxua^Xo, Qxua^Xo, Qxua^Xo, Qxua^Xo, Qxua^Xo, Qxua^Xo, Qxua^Xo, Qxua^Xo, Qxua^Xo, Qxua^Xo, Qxua^Xo, Qxua^Xo, Qxua^Xo, Qxua^Xo, Qxua^Xo, Qxua^Xo, Qxua^Xo, Qxua^Xo, Qxua^Xo, Qxua^Xo, Qxua^Xo, Qxua^Xo, Qxua^Xo, Qxua^Xo, Qxua^Xo, Qxua^Xo
Qxua^Xo, Qxua^Xo, Qxua^Xo, Qxua^Xo, Qxua^Xo, Qxua^Xo, Qxua^Xo, Qxua^Xo, Qxua^Xo, Qxua^Xo, Qxua^Xo, Qxua^Xo, Qxua^Xo, Qxua^Xo, Qxua^Xo, Qxua^Xo, Qxua^Xo, Qxua^Xo, Qxua^Xo, Qxua^Xo, Qxua^Xo, Qxua^Xo, Qxua^Xo, Qxua^Xo, Qxua^Xo, Qxua^Xo, Qxua^Xo, Qxua^Xo, Qxua^Xo, Qxua^Xo, Qxua^Xo, Qxua^Xo, Qxua^Xo, Qxua^Xo, Qxua^Xo
Qxua^Xo, Qxua^Xo, Qxua^Xo, Qxua^Xo, Qxua^Xo, Qxua^Xo, Qxua^Xo, Qxua^Xo, Qxua^Xo, Qxua^Xo, Gs, Gs, Gs^Gvs, Gs^Gvs, Gs^Gvs, Gs^Es, Gs^Es, Gs^Es, Gs, Gs^Es, Gs^Es, Gs, Mm, Mm, Ms^Xm, Qxua^Xo, Qxua^Xo, Qxua^Xo, Qxua^Xo, Qxua^Xo, Qxua^Xo, Qxua^Xo, Qxua^Xo, Qxua^Xo, Qxua^Xo
Qxua^Xo, Qxua^Xo, Qxua^Xo, Qxua^Xo, Qxua^Xo, Qxua^Xo, Qxua^Xo, Chr, Chr, Wwg, Wwg^Bsb/, Rp, Rp, Gs^Gvs, Rp, Rp, Rp, Gs^Es, Rb, Rb, Rb, Rb, Rb, Mm, Aa, Ms^Xm, Ms^Xm, Qxua^Xo, Qxua^Xo, Qxua^Xo, Qxua^Xo, Qxua^Xo, Qxua^Xo, Qxua^Xo, Qxua^Xo
Qxua^Xo, Qxua^Xo, Qxua^Xo, Qxua^Xo, Khr, Qxua^Xo, Qxua^Xo, Wwg, Wwg, 1 Kh, Wwg, Wwg, Gs^Vh, Rp, Gs^Gvs, Gs, Gs, Rp, Gs, Gs^Fp, Gs^Fp, Gs^Fp, Gs^Fp, Rb, Rb, Aa^Fpa, Aa^Fpa, Ms^Xm, Ms^Xm, Qxua^Xo, Qxua^Xo, Qxua^Xo, Qxua^Xo, Qxua^Xo, Qxua^Xo
Qxua^Xo, Qxua^Xo, Qxua^Xo, Qxua^Xo, Qxua^Xo, Qxua^Xo, Qxua^Xo, Wwg, Ss, Wwg, Ss, Wwg, Wwg, Gs^Gvs, Gs^Gvs, Gs^Gvs, Rb, Rp, Gs, Gs^Fp, Gs^Fp, Mm, Ms, Ha^Fpa, Ha^Fpa, Rb, Rb, Aa^Fpa, Ha, Ms^Xm, Qxua^Xo, Qxua^Xo, Qxua^Xo, Qxua^Xo, Qxua^Xo
Qxua^Xo, Qxua^Xo, Qxua^Xo, Qxua^Xo, Qxua^Xo, Qxua^Xo, Gs^Fp, Ss, Gs^Fp, Ss, Gs, Gs^Gvs, Gs^Gvs, Wwg, Wwg^Bw/r, Rb, Gs^Gvs, Rp, Rp, Gs, Hh, Mm, Mm, Ms, Ms, Aa^Fpa, Cea, Rb, Rb, Ms^Xm, Ms^Xm, Qxua^Xo, Qxua^Xo, Qxua^Xo, Qxua^Xo
Qxua^Xo, Qxua^Xo, Qxua^Xo, Qxua^Xo, Qxua^Xo, Gs^Fp, Gs^Fp, Gs^Fp, Gs^Fp, Gs^Fp, Mm, Gs^Gvs, Rb, Chr, Wog, Wog, Wog, Gs^Gvs, Gs, Rp, Rb, Hh^Fp, Hh^Fp, Mm, Ms, Ha^Fpa, Ha, Kea, Aa^Fpa, Rb^Vhs, Ms^Xm, Qxua^Xo, Qxua^Xo, Qxua^Xo, Qxua^Xo
Qxua^Xo, Qxua^Xo, Qxua^Xo, Qxua^Xo, Qxua^Xo, Gs^Fp, Gs^Fp, Gs^Fp, Gs^Fp, Mm, Gs, Gs, Rb, Gs^Gvs, Gs^Gvs, Wog, Wog, Wog, Wog^Bsb/, Rp, Gs, Rb, Hh^Fp, Mm, Mm, Ha^Fpa, Rb, Rb, Aa, Ms^Xm, Qxua^Xo, Qxua^Xo, Qxua^Xo, Qxua^Xo, Qxua^Xo
Qxua^Xo, Qxua^Xo, Qxua^Xo, Qxua^Xo, Qxua^Xo, Gs^Fp, Mm, Mm, Gs^Fp, Gs^Fp, Rb, Rb, Gs, Rb, Ss, Wwg, Rr^Vhc, Ch, Gs^Fds, Wwg, Ss, Rb, Hh, Mm, Gs, Aa^Fpa, Rb, Aa^Fpa, Aa^Fpa, Ms^Xm, Qxua^Xo, Qxua^Xo, Qxua^Xo, Qxua^Xo, Qxua^Xo
Qxua^Xo, Qxua^Xo, Qxua^Xo, Qxua^Xo, Qxua^Xo, Ms^Xm, Aa^Fpa, Mm, Rb, Rb, Gs, Gs, Hh, Rb, Ss, Wwg, Gs^Fds, Kh, Rr^Vhc, Wwg, Ss, Rb, Gs, Gs, Rb, Rb, Gs^Fp, Mm, Mm, Ms^Xm, Qxua^Xo, Qxua^Xo, Qxua^Xo, Qxua^Xo, Qxua^Xo
Qxua^Xo, Qxua^Xo, Qxua^Xo, Qxua^Xo, Qxua^Xo, Ms^Xm, Aa, Aa^Fpa, Rb, Aa^Fpa, Mm, Mm, Hh^Fp, Rb, Gs, Wwg, Wog^Bsb/, Ch, Wog, Wwg, Gs^Gvs, Rb, Rb, Rb, Gs, Gs^Fp, Gs^Fp, Mm, Gs^Fp, Gs^Fp, Qxua^Xo, Qxua^Xo, Qxua^Xo, Qxua^Xo, Qxua^Xo
Qxua^Xo, Qxua^Xo, Qxua^Xo, Qxua^Xo, Ms^Xm, Ms^Xm, Aa^Fpa, Rb, Ha, Ha^Fpa, Ms, Mm, Hh^Fp, Rb, Rb, Rp, Gs, Wog, Wog, Wog, Wog, Gs^Gvs, Rb, Gs, Mm, Mm, Gs^Fp, Gs^Fp, Gs^Fp, Gs^Fp, Qxua^Xo, Qxua^Xo, Qxua^Xo, Qxua^Xo, Qxua^Xo
Qxua^Xo, Qxua^Xo, Qxua^Xo, Qxua^Xo, Ms^Xm, Rb^Vd, Rb, Kea, Cea, Ha^Fpa, Ms, Mm, Mm, Hh^Fp, Hh, Rp, Rp, Gs^Gvs, Gs^Gvs, Wog, Wwg^Bw/r, Chr, Gs^Gvs, Gs^Gvs, Gs, Gs^Fp, Gs^Fp, Gs^Fp, Gs^Fp, Gs^Fp, Qxua^Xo, Qxua^Xo, Qxua^Xo, Qxua^Xo, Qxua^Xo
Qxua^Xo, Qxua^Xo, Qxua^Xo, Qxua^Xo, Qxua^Xo, Ms^Xm, Ha, Rb, Rb, Aa^Fpa, Ha^Fpa, Ms, Ms, Mm, Gs^Fp, Gs^Gvs, Gs^Gvs, Rp, Rb, Rb, Gs^Gvs, Wwg, Wwg, Gs^Gvs, Ss, Ss, Ss, Ss, Qxua^Xo, Qxua^Xo, Qxua^Xo, Qxua^Xo, Qxua^Xo, Qxua^Xo, Qxua^Xo
Qxua^Xo, Qxua^Xo, Qxua^Xo, Qxua^Xo, Qxua^Xo, Ms^Xm, Ms^Xm, Aa^Fpa, Aa^Fpa, Rb, Rb, Ha^Fpa, Gs^Fp, Mm, Gs^Fp, Gs^Fp, Gs, Rp, Gs, Gs^Gvs, Gs^Gvs, Gs^Gvs, Gs^Vh, Wwg, Wwg, Wwg, Wwg, Wwg, Qxua^Xo, Qxua^Xo, Khr, Qxua^Xo, Qxua^Xo, Qxua^Xo, Qxua^Xo
Qxua^Xo, Qxua^Xo, Qxua^Xo, Qxua^Xo, Qxua^Xo, Qxua^Xo, Qxua^Xo, Ms^Xm, Ms^Xm, Aa^Fpa, Aa, Rb, Rb, Gs^Fp, Rb, Gs^Fp, Rb, Rp, Rp, Gs, Rp, Rp, Rp, Wwg, Wwg^Bsb/, 2 Khr, Chr, Wwg, Qxua^Xo, Qxua^Xo, Qxua^Xo, Qxua^Xo, Qxua^Xo, Qxua^Xo, Qxua^Xo
Qxua^Xo, Qxua^Xo, Qxua^Xo, Qxua^Xo, Qxua^Xo, Qxua^Xo, Qxua^Xo, Qxua^Xo, Qxua^Xo, Ms^Xm, Ms^Xm, Mm, Mm, Rb, Gs, Rb, Gs, Gs^Es, Gs, Rp, Gs^Gvs, Gs^Gvs, Gs^Gvs, Rp, Gs, Wwg, Qxua^Xo, Chr, Qxua^Xo, Qxua^Xo, Qxua^Xo, Qxua^Xo, Qxua^Xo, Qxua^Xo, Qxua^Xo
Qxua^Xo, Qxua^Xo, Qxua^Xo, Qxua^Xo, Qxua^Xo, Qxua^Xo, Qxua^Xo, Qxua^Xo, Qxua^Xo, Qxua^Xo, Qxua^Xo, Mm, Qxua^Xo, Gs^Es, Qxua^Xo, Gs^Es, Qxua^Xo, Gs^Es, Qxua^Xo, Gs^Es, Qxua^Xo, Gs^Gvs, Qxua^Xo, Gs, Qxua^Xo, Qxua^Xo, Qxua^Xo, Qxua^Xo, Qxua^Xo, Qxua^Xo, Qxua^Xo, Qxua^Xo, Qxua^Xo, Qxua^Xo, Qxua^Xo
Qxua^Xo, Qxua^Xo, Qxua^Xo, Qxua^Xo, Qxua^Xo, Qxua^Xo, Qxua^Xo, Qxua^Xo, Qxua^Xo, Qxua^Xo, Qxua^Xo, Qxua^Xo, Qxua^Xo, Qxua^Xo, Qxua^Xo, Qxua^Xo, Qxua^Xo, Qxua^Xo, Qxua^Xo, Qxua^Xo, Qxua^Xo, Qxua^Xo, Qxua^Xo, Qxua^Xo, Qxua^Xo, Qxua^Xo, Qxua^Xo, Qxua^Xo, Qxua^Xo, Qxua^Xo, Qxua^Xo, Qxua^Xo, Qxua^Xo, Qxua^Xo, Qxua^Xo
Qxua^Xo, Qxua^Xo, Qxua^Xo, Qxua^Xo, Qxua^Xo, Qxua^Xo, Qxua^Xo, Qxua^Xo, Qxua^Xo, Qxua^Xo, Qxua^Xo, Qxua^Xo, Qxua^Xo, Qxua^Xo, Qxua^Xo, Qxua^Xo, Qxua^Xo, Qxua^Xo, Qxua^Xo, Qxua^Xo, Qxua^Xo, Qxua^Xo, Qxua^Xo, Qxua^Xo, Qxua^Xo, Qxua^Xo, Qxua^Xo, Qxua^Xo, Qxua^Xo, Qxua^Xo, Qxua^Xo, Qxua^Xo, Qxua^Xo, Qxua^Xo, Qxua^Xo
