border_size=1
usage=map

Qxua^Xo, Qxua^Xo, Qxua^Xo, Qxua^Xo, Qxua^Xo, Qxua^Xo, Qxua^Xo, Qxua^Xo, Qxua^Xo, Qxua^Xo, Qxua^Xo, Qxua^Xo, Qxua^Xo, Qxua^Xo, Qxua^Xo, Qxua^Xo, Qxua^Xo, Qxua^Xo, Qxua^Xo, Qxua^Xo, Qxua^Xo, Qxua^Xo, Qxua^Xo, Qxua^Xo, Qxua^Xo, Qxua^Xo, Qxua^Xo, Qxua^Xo, Qxua^Xo, Qxua^Xo, Qxua^Xo, Qxua, Qxua^Xo, Qxua^Xo, Qxua^Xo, Qxua^Xo
Qxua^Xo, Qxua^Xo, Qxua^Xo, Qxua^Xo, Qxua^Xo, Qxua^Xo, Qxua^Xo, Qxua^Xo, Qxua^Xo, Qxua^Xo, Qxua^Xo, Qxua^Xo, Qxua^Xo, Qxua^Xo, Qxua^Xo, Qxua^Xo, Qxua^Xo, Qxua^Xo, Qxua^Xo, Qxua^Xo, Qxua^Xo, Qxua^Xo, Qxua^Xo, Qxua^Xo, Qxua^Xo, Qxua^Xo, Qxua^Xo, Qxua^Xo, Qxua^Xo, Qxua^Xo, Qxua^Xo, Qxua^Xo, Qxua^Xo, Qxua^Xo, Qxua^Xo, Qxua^Xo
Qxua^Xo, Qxua^Xo, Qxua^Xo, Qxua^Xo, Qxua^Xo, Qxua^Xo, Qxua^Xo, Qxua^Xo, Qxua^Xo, Qxua^Xo, Gd, Gd, Gd, Gd, Gd, Gd^Es, Gd^Es, Gd^Es, Gd, Gd^Es, Gd^Es, Gd, Mm, Mm, Ms^Xm, Qxua^Xo, Qxua^Xo, Qxua^Xo, Qxua^Xo, Qxua^Xo, Qxua^Xo, Qxua^Xo, Qxua^Xo, Qxua^Xo, Qxua^Xo, Qxua^Xo
Qxua^Xo, Qxua^Xo, Qxua^Xo, Qxua^Xo, Qxua^Xo, Qxua^Xo, Qxua^Xo, Chr, Chr, Wwf, Wwf^Bsb/, Rp, Rp, Gd^Es, Rp, Rp, Rp, Gd^Es, Rb, Rb, Rb, Rb, Rb, Mm, Aa, Ms^Xm, Ms^Xm, Qxua^Xo, Qxua^Xo, Qxua^Xo, Qxua^Xo, Qxua^Xo, Qxua^Xo, Qxua^Xo, Qxua^Xo, Qxua^Xo
Qxua^Xo, Qxua^Xo, Qxua^Xo, Qxua^Xo, Qxua^Xo, Qxua^Xo, Qxua^Xo, Wwf, Wwf, 1 Kh, Wwf, Wwf, Gd^Vh, Rp, Gd^Es, Gd^Es, Gd^Es, Rp, Gd, Gd^Fdw, Gd^Fdw, Gd^Fdw, Gd^Fdw, Rb, Rb, Aa^Fpa, Aa^Fpa, Ms^Xm, Ms^Xm, Qxua^Xo, Qxua^Xo, Qxua^Xo, Qxua^Xo, Qxua^Xo, Qxua^Xo, Qxua^Xo
Qxua^Xo, Qxua^Xo, Qxua^Xo, Qxua^Xo, Qxua^Xo, Qxua^Xo, Qxua^Xo, Wwf, Ss, Wwf, Ss, Wwf, Wwf, Gd, Gd, Gd^Es, Rb, Rp, Gd, Gd^Fdw, Gd^Fdw, Mm, Ms, Ha^Fpa, Ha^Fpa, Rb, Rb, Aa^Fpa, Ha, Ms^Xm, Qxua^Xo, Qxua^Xo, Qxua^Xo, Qxua^Xo, Qxua^Xo, Qxua^Xo
Qxua^Xo, Qxua^Xo, Qxua^Xo, Qxua^Xo, Qxua^Xo, Qxua^Xo, Gd^Fdw, Ss, Gd^Fdw, Ss, Gd, Gd^Es, Gd^Es, Wwf, Wwf^Bw/r, Rb, Gd, Rp, Rp, Gd, Hhd, Mm, Mm, Ms, Ms, Aa^Fpa, Cea, Rb, Rb, Ms^Xm, Ms^Xm, Qxua^Xo, Qxua^Xo, Qxua^Xo, Qxua^Xo, Qxua^Xo
Qxua^Xo, Qxua^Xo, Qxua^Xo, Qxua^Xo, Qxua^Xo, Gd^Fdw, Gd^Fdw, Gd^Fdw, Gd^Fdw, Gd^Fdw, Mm, Gd, Rb, Chr, Wwg, Wwg, Wwg, Gd^Es, Gd^Es, Rp, Rb, Hhd^Fdw, Hhd^Fdw, Mm, Ms, Ha^Fpa, Ha, Kea, Aa^Fpa, Rb^Vhs, Ms^Xm, Qxua^Xo, Qxua^Xo, Qxua^Xo, Qxua^Xo, Qxua^Xo
Qxua^Xo, Qxua^Xo, Qxua^Xo, Qxua^Xo, Qxua^Xo, Gd^Fdw, Gd^Fdw, Gd^Fdw, Gd^Fdw, Mm, Gd^Es, Gd^Es, Rb, Gd^Es, Gd^Es, Wwg, Wwg, Wwg, Wwg^Bsb/, Rp, Gd, Rb, Hhd^Fdw, Mm, Mm, Ha^Fpa, Rb, Rb, Aa, Ms^Xm, Qxua^Xo, Qxua^Xo, Qxua^Xo, Qxua^Xo, Qxua^Xo, Qxua^Xo
Qxua^Xo, Qxua^Xo, Qxua^Xo, Qxua^Xo, Qxua^Xo, Gd^Fdw, Mm, Mm, Gd^Fdw, Gd^Fdw, Rb, Rb, Gd, Rb, Ss, Wwg, Rr^Vhc, Ch, Gd^Fdw, Wwg, Ss, Rb, Hhd, Mm, Gd^Es, Aa^Fpa, Rb, Aa^Fpa, Aa^Fpa, Ms^Xm, Qxua^Xo, Qxua^Xo, Qxua^Xo, Qxua^Xo, Qxua^Xo, Qxua^Xo
Qxua^Xo, Qxua^Xo, Qxua^Xo, Qxua^Xo, Qxua^Xo, Ms^Xm, Aa^Fpa, Mm, Rb, Rb, Gd^Es, Gd, Hhd, Rb, Ss, Wwg, Gd^Fdw, Kh, Rr^Vhc, Wwg, Ss, Rb, Gd, Gd, Rb, Rb, Gd^Fdw, Md, Md, Ms^Xm, Qxua^Xo, Qxua^Xo, Qxua^Xo, Qxua^Xo, Qxua^Xo, Qxua^Xo
Qxua^Xo, Qxua^Xo, Qxua^Xo, Qxua^Xo, Qxua^Xo, Ms^Xm, Aa, Aa^Fpa, Rb, Aa^Fpa, Mm, Mm, Hhd^Fdw, Rb, Gd, Wwg, Wwg^Bsb/, Ch, Wwg, Wwg, Gd^Es, Rb, Rb, Rb, Gd^Es, Gd^Fdw, Gd^Fdw, Md, Gd^Fdw, Gd^Fdw, Qxua^Xo, Qxua^Xo, Qxua^Xo, Qxua^Xo, Qxua^Xo, Qxua^Xo
Qxua^Xo, Qxua^Xo, Qxua^Xo, Qxua^Xo, Ms^Xm, Ms^Xm, Aa^Fpa, Rb, Ha, Ha^Fpa, Ms, Mm, Hhd^Fdw, Rb, Rb, Rp, Gd, Wwg, Wwg, Wwg, Wwg, Gd^Es, Rb, Gd^Es, Md, Md, Gd^Fdw, Gd^Fdw, Gd^Fdw, Gd^Fdw, Qxua^Xo, Qxua^Xo, Qxua^Xo, Qxua^Xo, Qxua^Xo, Qxua^Xo
Qxua^Xo, Qxua^Xo, Qxua^Xo, Qxua^Xo, Ms^Xm, Rb^Vd, Rb, Kea, Cea, Ha^Fpa, Ms, Mm, Mm, Hhd^Fdw, Hhd, Rp, Rp, Gd^Es, Gd^Es, Wwg, Wwf^Bw/r, Chr, Gd^Es, Gd, Gd, Gd^Fdw, Gd^Fdw, Gd^Fdw, Gd^Fdw, Gd^Fdw, Qxua^Xo, Qxua^Xo, Qxua^Xo, Qxua^Xo, Qxua^Xo, Qxua^Xo
Qxua^Xo, Qxua^Xo, Qxua^Xo, Qxua^Xo, Qxua^Xo, Ms^Xm, Ha, Rb, Rb, Aa^Fpa, Ha^Fpa, Ms, Ms, Mm, Gd^Fdw, Gd, Gd, Rp, Rb, Rb, Gd, Wwf, Wwf, Gd^Es, Ss, Ss, Ss, Ss, Qxua^Xo, Qxua^Xo, Qxua^Xo, Qxua^Xo, Qxua^Xo, Qxua^Xo, Qxua^Xo, Qxua^Xo
Qxua^Xo, Qxua^Xo, Qxua^Xo, Qxua^Xo, Qxua^Xo, Ms^Xm, Ms^Xm, Aa^Fpa, Aa^Fpa, Rb, Rb, Ha^Fpa, Gd^Fdw, Mm, Gd^Fdw, Gd^Fdw, Gd, Rp, Gd^Es, Gd^Es, Gd^Es, Gd, Gd^Vh, Wwf, Wwf, Wwf, Wwf, Wwf, Qxua^Xo, Qxua^Xo, Qxua^Xo, Qxua^Xo, Qxua^Xo, Qxua^Xo, Qxua^Xo, Qxua^Xo
Qxua^Xo, Qxua^Xo, Qxua^Xo, Qxua^Xo, Qxua^Xo, Qxua^Xo, Qxua^Xo, Ms^Xm, Ms^Xm, Aa^Fpa, Aa, Rb, Rb, Gd^Fdw, Rb, Gd^Fdw, Rb, Rp, Rp, Gd^Es, Rp, Rp, Rp, Wwf, Wwf^Bsb/, 2 Khr, Chr, Wwf, Qxua^Xo, Qxua^Xo, Qxua^Xo, Qxua^Xo, Qxua^Xo, Qxua^Xo, Qxua^Xo, Qxua^Xo
Qxua^Xo, Qxua^Xo, Qxua^Xo, Qxua^Xo, Qxua^Xo, Qxua^Xo, Qxua^Xo, Qxua^Xo, Qxua^Xo, Ms^Xm, Ms^Xm, Mm, Mm, Rb, Gd, Rb, Gd, Gd^Es, Gd, Rp, Gd, Gd^Es, Gd, Rp, Gd, Wwf, Qxua^Xo, Chr, Qxua^Xo, Qxua^Xo, Qxua^Xo, Qxua^Xo, Qxua^Xo, Qxua^Xo, Qxua^Xo, Qxua^Xo
Qxua^Xo, Qxua^Xo, Qxua^Xo, Qxua^Xo, Qxua^Xo, Qxua^Xo, Qxua^Xo, Qxua^Xo, Qxua^Xo, Qxua^Xo, Qxua^Xo, Mm, Qxua^Xo, Gd^Es, Qxua^Xo, Gd^Es, Qxua^Xo, Gd^Es, Qxua^Xo, Gd^Es, Qxua^Xo, Gd, Qxua^Xo, Gd, Qxua^Xo, Qxua^Xo, Qxua^Xo, Qxua^Xo, Qxua^Xo, Qxua^Xo, Qxua^Xo, Qxua^Xo, Qxua^Xo, Qxua^Xo, Qxua^Xo, Qxua^Xo
Qxua^Xo, Qxua^Xo, Qxua^Xo, Qxua^Xo, Qxua^Xo, Qxua^Xo, Qxua^Xo, Qxua^Xo, Qxua^Xo, Qxua^Xo, Qxua^Xo, Qxua^Xo, Qxua^Xo, Qxua^Xo, Qxua^Xo, Qxua^Xo, Qxua^Xo, Qxua^Xo, Qxua^Xo, Qxua^Xo, Qxua^Xo, Qxua^Xo, Qxua^Xo, Qxua^Xo, Qxua^Xo, Qxua^Xo, Qxua^Xo, Qxua^Xo, Qxua^Xo, Qxua^Xo, Qxua^Xo, Qxua^Xo, Qxua^Xo, Qxua^Xo, Qxua^Xo, Qxua^Xo
Qxua^Xo, Qxua^Xo, Qxua^Xo, Qxua^Xo, Qxua^Xo, Qxua^Xo, Qxua^Xo, Qxua^Xo, Qxua^Xo, Qxua^Xo, Qxua^Xo, Qxua^Xo, Qxua^Xo, Qxua^Xo, Qxua^Xo, Qxua^Xo, Qxua^Xo, Qxua^Xo, Qxua^Xo, Qxua^Xo, Qxua^Xo, Qxua^Xo, Qxua^Xo, Qxua^Xo, Qxua^Xo, Qxua^Xo, Qxua^Xo, Qxua^Xo, Qxua^Xo, Qxua^Xo, Qxua^Xo, Qxua^Xo, Qxua^Xo, Qxua^Xo, Qxua^Xo, Qxua^Xo
