border_size=1
usage=map

Qxua^Xo, Qxua^Xo, Qxua^Xo, Qxua^Xo, Qxua^Xo, Qxua^Xo, Qxua^Xo, Qxua^Xo, Qxua^Xo, Qxua^Xo, Qxua^Xo, Qxua^Xo, Qxua^Xo, Qxua^Xo, Qxua^Xo, Qxua^Xo, Qxua^Xo, Qxua^Xo, Qxua^Xo, Qxua^Xo, Qxua^Xo, Qxua^Xo, Qxua^Xo, Qxua^Xo, Qxua^Xo, Qxua^Xo, Qxua^Xo, Qxua^Xo, Qxua^Xo, Qxua^Xo, Qxua^Xo, Qxua^Xo, Qxua^Xo, Qxua^Xo, Qxua^Xo
Qxua^Xo, Qxua^Xo, Qxua^Xo, Qxua^Xo, Qxua^Xo, Qxua^Xo, Qxua^Xo, Qxua^Xo, Qxua^Xo, Qxua^Xo, Qxua^Xo, Qxua^Xo, Qxua^Xo, Qxua^Xo, Qxua^Xo, Qxua^Xo, Qxua^Xo, Qxua^Xo, Qxua^Xo, Qxua^Xo, Qxua^Xo, Qxua^Xo, Qxua^Xo, Qxua^Xo, Qxua^Xo, Qxua^Xo, Qxua^Xo, Qxua^Xo, Qxua^Xo, Qxua^Xo, Qxua^Xo, Qxua^Xo, Qxua^Xo, Qxua^Xo, Qxua^Xo
Qxua^Xo, Qxua^Xo, Qxua^Xo, Qxua^Xo, Qxua^Xo, Qxua^Xo, Qxua^Xo, Qxua^Xo, Qxua^Xo, Qxua^Xo, Gg^Efm, Gg, Gg^Gvs, Gg^Gvs, Gg^Gvs, Gg^Es, Gg^Es, Gg^Es, Gg^Efm, Gg^Es, Gg^Es, Gg, Mm, Mm, Mm^Xm, Qxua^Xo, Qxua^Xo, Qxua^Xo, Qxua^Xo, Qxua^Xo, Qxua^Xo, Qxua^Xo, Qxua^Xo, Qxua^Xo, Qxua^Xo
Qxua^Xo, Qxua^Xo, Qxua^Xo, Qxua^Xo, Qxua^Xo, Qxua^Xo, Qxua^Xo, Chr, Chr, Wwg, Wwg^Bsb/, Rp, Rp, Gg^Gvs, Rp, Rp, Rp, Gg^Es, Rb, Rb, Rb, Rb, Rb, Mm, Gg^Efm, Mm^Xm, Mm^Xm, Qxua^Xo, Qxua^Xo, Qxua^Xo, Qxua^Xo, Qxua^Xo, Qxua^Xo, Qxua^Xo, Qxua^Xo
Qxua^Xo, Qxua^Xo, Qxua^Xo, Qxua^Xo, Khr, Qxua^Xo, Qxua^Xo, Wwg, Wwg, 1 Kh, Wwg, Wwg, Gg^Vh, Rp, Gg^Gvs, Gg^Efm, Gg^Efm, Rp, Gg, Gg^Fds, Gg^Fds, Gg^Fds, Gg^Fds, Rb, Rb, Gg^Fds, Gg^Fds, Mm^Xm, Mm^Xm, Qxua^Xo, Qxua^Xo, Qxua^Xo, Qxua^Xo, Qxua^Xo, Qxua^Xo
Qxua^Xo, Qxua^Xo, Qxua^Xo, Qxua^Xo, Qxua^Xo, Qxua^Xo, Qxua^Xo, Wwg, Gg, Wwg, Gg, Wwg, Wwg, Gg^Gvs, Gg^Gvs, Gg^Gvs, Rb, Rp, Gg^Efm, Gg^Fds, Gg^Fds, Mm, Mm, Hh^Fds, Hh^Fds, Rb, Rb, Gg^Fds, Hh, Mm^Xm, Qxua^Xo, Qxua^Xo, Qxua^Xo, Qxua^Xo, Qxua^Xo
Qxua^Xo, Qxua^Xo, Qxua^Xo, Qxua^Xo, Qxua^Xo, Qxua^Xo, Gg^Fds, Gg, Gg^Fds, Gg^Efm, Gs^Efm, Gg^Gvs, Gg^Gvs, Wwg, Wwg^Bw/r, Rb, Gg^Gvs, Rp, Rp, Gg, Hh, Mm, Mm, Mm, Mm, Gg^Fds, Ce, Rb, Rb, Mm^Xm, Mm^Xm, Qxua^Xo, Qxua^Xo, Qxua^Xo, Qxua^Xo
Qxua^Xo, Qxua^Xo, Qxua^Xo, Qxua^Xo, Qxua^Xo, Gg^Fds, Gg^Fds, Gg^Fds, Gg^Fds, Gg^Fds, Mm, Gg^Gvs, Rb, Chr, Wog, Wog, Wog, Gg^Gvs, Gg, Rp, Rb, Hh^Fds, Hh^Fds, Mm, Mm, Hh^Fds, Hh, Ke, Gg^Fds, Rb^Vhs, Mm^Xm, Qxua^Xo, Qxua^Xo, Qxua^Xo, Qxua^Xo
Qxua^Xo, Qxua^Xo, Qxua^Xo, Qxua^Xo, Qxua^Xo, Gg^Fds, Gg^Fds, Gg^Fds, Gg^Fds, Mm, Gg^Efm, Gg, Rb, Gg^Gvs, Gg^Gvs, Wog, Wog, Wog, Wog^Bsb/, Rp, Gg, Rb, Hh^Fds, Mm, Mm, Hh^Fds, Rb, Rb, Gg^Efm, Mm^Xm, Qxua^Xo, Qxua^Xo, Qxua^Xo, Qxua^Xo, Qxua^Xo
Qxua^Xo, Qxua^Xo, Qxua^Xo, Qxua^Xo, Qxua^Xo, Gg^Fds, Mm, Mm, Gg^Fds, Gg^Fds, Rb, Rb, Gg, Rb, Gg^Efm, Wwg, Rr^Vhc, Ch, Gs^Fds, Wwg, Gg^Efm, Rb, Hh, Mm, Gg, Gg^Fds, Rb, Gg^Fds, Gg^Fds, Mm^Xm, Qxua^Xo, Qxua^Xo, Qxua^Xo, Qxua^Xo, Qxua^Xo
Qxua^Xo, Qxua^Xo, Qxua^Xo, Qxua^Xo, Qxua^Xo, Mm^Xm, Gg^Fds, Mm, Rb, Rb, Gg, Gg^Efm, Hh, Rb, Gg^Efm, Wwg, Gs^Fds, Kh, Rr^Vhc, Wwg, Gg^Efm, Rb, Gg, Gg^Efm, Rb, Rb, Gg^Fds, Mm, Mm, Mm^Xm, Qxua^Xo, Qxua^Xo, Qxua^Xo, Qxua^Xo, Qxua^Xo
Qxua^Xo, Qxua^Xo, Qxua^Xo, Qxua^Xo, Qxua^Xo, Mm^Xm, Gg^Efm, Gg^Fds, Rb, Gg^Fds, Mm, Mm, Hh^Fds, Rb, Gg, Wwg, Wog^Bsb/, Ch, Wog, Wwg, Gg^Gvs, Rb, Rb, Rb, Gg^Efm, Gg^Fds, Gg^Fds, Mm, Gg^Fds, Gg^Fds, Qxua^Xo, Qxua^Xo, Qxua^Xo, Qxua^Xo, Qxua^Xo
Qxua^Xo, Qxua^Xo, Qxua^Xo, Qxua^Xo, Mm^Xm, Mm^Xm, Gg^Fds, Rb, Hh, Hh^Fds, Mm, Mm, Hh^Fds, Rb, Rb, Rp, Gg, Wog, Wog, Wog, Wog, Gg^Gvs, Rb, Gg, Mm, Mm, Gg^Fds, Gg^Fds, Gg^Fds, Gg^Fds, Qxua^Xo, Qxua^Xo, Qxua^Xo, Qxua^Xo, Qxua^Xo
Qxua^Xo, Qxua^Xo, Qxua^Xo, Qxua^Xo, Mm^Xm, Rb^Vd, Rb, Ke, Ce, Hh^Fds, Mm, Mm, Mm, Hh^Fds, Hh, Rp, Rp, Gg^Gvs, Gg^Gvs, Wog, Wwg^Bw/r, Chr, Gg^Gvs, Gg^Gvs, Gg^Efm, Gg^Fds, Gg^Fds, Gg^Fds, Gg^Fds, Gg^Fds, Qxua^Xo, Qxua^Xo, Qxua^Xo, Qxua^Xo, Qxua^Xo
Qxua^Xo, Qxua^Xo, Qxua^Xo, Qxua^Xo, Qxua^Xo, Mm^Xm, Hh, Rb, Rb, Gg^Fds, Hh^Fds, Mm, Mm, Mm, Gg^Fds, Gg^Gvs, Gg^Gvs, Rp, Rb, Rb, Gg^Gvs, Wwg, Wwg, Gg^Gvs, Gg, Gg^Efm, Gg, Gg, Qxua^Xo, Qxua^Xo, Qxua^Xo, Qxua^Xo, Qxua^Xo, Qxua^Xo, Qxua^Xo
Qxua^Xo, Qxua^Xo, Qxua^Xo, Qxua^Xo, Qxua^Xo, Mm^Xm, Mm^Xm, Gg^Fds, Gg^Fds, Rb, Rb, Hh^Fds, Gg^Fds, Mm, Gg^Fds, Gg^Fds, Gg^Efm, Rp, Gg^Efm, Gg^Gvs, Gg^Gvs, Gg^Gvs, Gg^Vh, Wwg, Wwg, Wwg, Wwg, Wwg, Qxua^Xo, Qxua^Xo, Khr, Qxua^Xo, Qxua^Xo, Qxua^Xo, Qxua^Xo
Qxua^Xo, Qxua^Xo, Qxua^Xo, Qxua^Xo, Qxua^Xo, Qxua^Xo, Qxua^Xo, Mm^Xm, Mm^Xm, Gg^Fds, Gg^Efm, Rb, Rb, Gg^Fds, Rb, Gg^Fds, Rb, Rp, Rp, Gg^Efm, Rp, Rp, Rp, Wwg, Wwg^Bsb/, 2 Khr, Chr, Wwg, Qxua^Xo, Qxua^Xo, Qxua^Xo, Qxua^Xo, Qxua^Xo, Qxua^Xo, Qxua^Xo
Qxua^Xo, Qxua^Xo, Qxua^Xo, Qxua^Xo, Qxua^Xo, Qxua^Xo, Qxua^Xo, Qxua^Xo, Qxua^Xo, Mm^Xm, Mm^Xm, Mm, Mm, Rb, Gg, Rb, Gg^Efm, Gg^Es, Gg, Rp, Gg^Gvs, Gg^Gvs, Gg^Gvs, Rp, Gg^Efm, Wwg, Qxua^Xo, Chr, Qxua^Xo, Qxua^Xo, Qxua^Xo, Qxua^Xo, Qxua^Xo, Qxua^Xo, Qxua^Xo
Qxua^Xo, Qxua^Xo, Qxua^Xo, Qxua^Xo, Qxua^Xo, Qxua^Xo, Qxua^Xo, Qxua^Xo, Qxua^Xo, Qxua^Xo, Qxua^Xo, Mm, Qxua^Xo, Gg^Es, Qxua^Xo, Gg^Es, Qxua^Xo, Gg^Es, Qxua^Xo, Gg^Es, Qxua^Xo, Gg^Gvs, Qxua^Xo, Gg, Qxua^Xo, Qxua^Xo, Qxua^Xo, Qxua^Xo, Qxua^Xo, Qxua^Xo, Qxua^Xo, Qxua^Xo, Qxua^Xo, Qxua^Xo, Qxua^Xo
Qxua^Xo, Qxua^Xo, Qxua^Xo, Qxua^Xo, Qxua^Xo, Qxua^Xo, Qxua^Xo, Qxua^Xo, Qxua^Xo, Qxua^Xo, Qxua^Xo, Qxua^Xo, Qxua^Xo, Qxua^Xo, Qxua^Xo, Qxua^Xo, Qxua^Xo, Qxua^Xo, Qxua^Xo, Qxua^Xo, Qxua^Xo, Qxua^Xo, Qxua^Xo, Qxua^Xo, Qxua^Xo, Qxua^Xo, Qxua^Xo, Qxua^Xo, Qxua^Xo, Qxua^Xo, Qxua^Xo, Qxua^Xo, Qxua^Xo, Qxua^Xo, Qxua^Xo
Qxua^Xo, Qxua^Xo, Qxua^Xo, Qxua^Xo, Qxua^Xo, Qxua^Xo, Qxua^Xo, Qxua^Xo, Qxua^Xo, Qxua^Xo, Qxua^Xo, Qxua^Xo, Qxua^Xo, Qxua^Xo, Qxua^Xo, Qxua^Xo, Qxua^Xo, Qxua^Xo, Qxua^Xo, Qxua^Xo, Qxua^Xo, Qxua^Xo, Qxua^Xo, Qxua^Xo, Qxua^Xo, Qxua^Xo, Qxua^Xo, Qxua^Xo, Qxua^Xo, Qxua^Xo, Qxua^Xo, Qxua^Xo, Qxua^Xo, Qxua^Xo, Qxua^Xo
