border_size=1
usage=map

Qxua^Xo, Qxua^Xo, Qxua^Xo, Qxua^Xo, Qxua^Xo, Qxua^Xo, Qxua^Xo, Qxua^Xo, Qxua^Xo, Qxua^Xo, Qxua^Xo, Qxua^Xo, Qxua^Xo, Qxua^Xo, Qxua^Xo, Qxua^Xo, Qxua^Xo, Qxua^Xo, Qxua^Xo, Qxua^Xo, Qxua^Xo, Qxua^Xo, Qxua^Xo, Qxua^Xo, Qxua^Xo, Qxua^Xo, Qxua^Xo, Qxua^Xo, Qxua^Xo, Qxua^Xo, Qxua^Xo, Qxua^Xo, Qxua^Xo, Qxua^Xo, Qxua^Xo
Qxua^Xo, Qxua^Xo, Qxua^Xo, Qxua^Xo, Qxua^Xo, Qxua^Xo, Qxua^Xo, Qxua^Xo, Qxua^Xo, Qxua^Xo, Qxua^Xo, Qxua^Xo, Qxua^Xo, Qxua^Xo, Qxua^Xo, Qxua^Xo, Qxua^Xo, Qxua^Xo, Qxua^Xo, Qxua^Xo, Qxua^Xo, Qxua^Xo, Qxua^Xo, Qxua^Xo, Qxua^Xo, Qxua^Xo, Qxua^Xo, Qxua^Xo, Qxua^Xo, Qxua^Xo, Qxua^Xo, Qxua^Xo, Qxua^Xo, Qxua^Xo, Qxua^Xo
Qxua^Xo, Qxua^Xo, Qxua^Xo, Qxua^Xo, Qxua^Xo, Qxua^Xo, Qxua^Xo, Qxua^Xo, Qxua^Xo, Qxua^Xo, Gs, Gs, Rb^Gvs, Rb^Gvs, Rb^Gvs, Gll^Ftr, Gll^Ftr, Gll^Ftr, Gll^Ftr, Gll^Ftr, Gll^Ftr, Gll^Ftr, Mm, Mm, Mm^Xm, Qxua^Xo, Qxua^Xo, Qxua^Xo, Qxua^Xo, Qxua^Xo, Qxua^Xo, Qxua^Xo, Qxua^Xo, Qxua^Xo, Qxua^Xo
Qxua^Xo, Qxua^Xo, Qxua^Xo, Qxua^Xo, Qxua^Xo, Qxua^Xo, Qxua^Xo, Chr, Chr, Wwg, Wwg^Bsb/, Rp, Rp, Rb^Gvs, Rp, Rp, Rp, Gll^Ftr, Rb, Rb, Rb, Rb, Rb, Mm, Rb, Mm^Xm, Mm^Xm, Qxua^Xo, Qxua^Xo, Qxua^Xo, Qxua^Xo, Qxua^Xo, Qxua^Xo, Qxua^Xo, Qxua^Xo
Qxua^Xo, Qxua^Xo, Qxua^Xo, Qxua^Xo, Khr, Qxua^Xo, Qxua^Xo, Wwg, Wwg, 1 Kh, Wwg, Wwg, Gs^Vh, Rp, Rb^Gvs, Gll^Ftr, Gs, Rp, Gs, Gs^Ftr, Gs^Ftr, Gs^Ftr, Gs^Ftr, Rb, Rb, Gll^Ftr, Gll^Ftr, Mm^Xm, Mm^Xm, Qxua^Xo, Qxua^Xo, Qxua^Xo, Qxua^Xo, Qxua^Xo, Qxua^Xo
Qxua^Xo, Qxua^Xo, Qxua^Xo, Qxua^Xo, Qxua^Xo, Qxua^Xo, Qxua^Xo, Wwg, Ss, Wwg, Ss, Wwg, Wwg, Ss, Rb^Gvs, Gll^Ftr, Ss, Rp, Gs, Gs^Ftr, Gs^Ftr, Gll^Ftr, Gll^Ftr, Hh^Ftr, Hh^Ftr, Rb, Rb, Gll^Ftr, Hh, Mm^Xm, Qxua^Xo, Qxua^Xo, Qxua^Xo, Qxua^Xo, Qxua^Xo
Qxua^Xo, Qxua^Xo, Qxua^Xo, Qxua^Xo, Qxua^Xo, Qxua^Xo, Gs^Ft, Ss, Gs^Ft, Ss, Gs, Ss, Rb^Gvs, Wwg, Wwg^Bw/r, Ss, Ss, Rp, Ss, Gs, Hh, Gll^Ftr, Gll^Ftr, Gll^Ftr, Gll^Ftr, Gll^Ftr, Ce, Rb, Rb, Mm^Xm, Mm^Xm, Qxua^Xo, Qxua^Xo, Qxua^Xo, Qxua^Xo
Qxua^Xo, Qxua^Xo, Qxua^Xo, Qxua^Xo, Qxua^Xo, Gs^Ft, Gs^Ft, Gs^Ft, Gs^Ft, Gs^Ft, Mm, Rb^Gvs, Rb, Chr, Wog, Wog, Wog, Wwg, Wwg, Ss, Rb, Hh^Ftr, Hh^Ftr, Gll^Ftr, Gll^Ftr, Hh^Ftr, Hh, Ke, Gll^Ftr, Rb^Vhs, Mm^Xm, Qxua^Xo, Qxua^Xo, Qxua^Xo, Qxua^Xo
Qxua^Xo, Qxua^Xo, Qxua^Xo, Qxua^Xo, Qxua^Xo, Gs^Ft, Gs^Ft, Gs^Ft, Gs^Ft, Mm, Gll^Ftr, Gll^Ftr, Rb, Ss, Wwg, Wog, Wog, Wog, Wog^Bsb/, Rp, Wwg, Rb, Hh^Ftr, Gll^Ftr, Gll^Ftr, Hh^Ftr, Rb, Rb, Rb, Mm^Xm, Qxua^Xo, Qxua^Xo, Qxua^Xo, Qxua^Xo, Qxua^Xo
Qxua^Xo, Qxua^Xo, Qxua^Xo, Qxua^Xo, Qxua^Xo, Gs^Ft, Mm, Mm, Gs^Ft, Gs^Ft, Rb, Rb, Ss, Rb, Wwg, Wog, Rr^Vhc, Ch, Gs^Ft, Wog, Wwg, Ss, Hh, Gll^Ftr, Gs, Gll^Ftr, Rb, Gll^Ftr, Gll^Ftr, Mm^Xm, Qxua^Xo, Qxua^Xo, Qxua^Xo, Qxua^Xo, Qxua^Xo
Qxua^Xo, Qxua^Xo, Qxua^Xo, Qxua^Xo, Qxua^Xo, Mm^Xm, Gll^Ftr, Mm, Rb, Rb, Gs, Gs, Hh, Ss, Wwg, Wwg, Gs^Ft, Kh, Rr^Vhc, Wwg, Wwg, Ss, Ss, Gs, Rb, Rb, Gs^Ft, Mm, Mm, Mm^Xm, Qxua^Xo, Qxua^Xo, Qxua^Xo, Qxua^Xo, Qxua^Xo
Qxua^Xo, Qxua^Xo, Qxua^Xo, Qxua^Xo, Qxua^Xo, Mm^Xm, Rb, Gll^Ftr, Rb, Gll^Ftr, Gll^Ftr, Gll^Ftr, Hh^Ftr, Ss, Wwg, Wog, Wog^Bsb/, Ch, Wog, Wog, Wwg, Rb, Rb, Rb, Gll^Ftr, Gs^Ft, Gs^Ft, Mm, Gs^Ft, Gs^Ft, Qxua^Xo, Qxua^Xo, Qxua^Xo, Qxua^Xo, Qxua^Xo
Qxua^Xo, Qxua^Xo, Qxua^Xo, Qxua^Xo, Mm^Xm, Mm^Xm, Gll^Ftr, Rb, Hh, Hh^Ftr, Gll^Ftr, Gll^Ftr, Hh^Ftr, Rb, Rb, Rp, Wwg, Wog, Wog, Wog, Wog, Ss, Rb, Gll^Ftr, Mm, Mm, Gs^Ft, Gs^Ft, Gs^Ft, Gs^Ft, Qxua^Xo, Qxua^Xo, Qxua^Xo, Qxua^Xo, Qxua^Xo
Qxua^Xo, Qxua^Xo, Qxua^Xo, Qxua^Xo, Mm^Xm, Rb^Vd, Rb, Ke, Ce, Hh^Ftr, Gll^Ftr, Gll^Ftr, Gll^Ftr, Hh^Ftr, Hh, Ss, Ss, Wwg, Ss, Wog, Wwg^Bw/r, Chr, Rb^Gvs, Rb^Gvs, Gs, Gs^Ft, Gs^Ft, Gs^Ft, Gs^Ft, Gs^Ft, Qxua^Xo, Qxua^Xo, Qxua^Xo, Qxua^Xo, Qxua^Xo
Qxua^Xo, Qxua^Xo, Qxua^Xo, Qxua^Xo, Qxua^Xo, Mm^Xm, Hh, Rb, Rb, Gll^Ftr, Hh^Ftr, Gll^Ftr, Gll^Ftr, Gll^Ftr, Gs^Ftr, Rb^Gvs, Rb^Gvs, Rp, Ss, Ss, Rb^Gvs, Wwg, Wwg, Ss, Ss, Ss, Ss, Ss, Qxua^Xo, Qxua^Xo, Qxua^Xo, Qxua^Xo, Qxua^Xo, Qxua^Xo, Qxua^Xo
Qxua^Xo, Qxua^Xo, Qxua^Xo, Qxua^Xo, Qxua^Xo, Mm^Xm, Mm^Xm, Gll^Ftr, Gll^Ftr, Rb, Rb, Hh^Ftr, Gs^Ftr, Gll^Ftr, Gs^Ftr, Gs^Ftr, Rb, Rp, Gs, Gll^Ftr, Rb^Gvs, Ss, Gs^Vh, Wwg, Wwg, Wwg, Wwg, Wwg, Qxua^Xo, Qxua^Xo, Khr, Qxua^Xo, Qxua^Xo, Qxua^Xo, Qxua^Xo
Qxua^Xo, Qxua^Xo, Qxua^Xo, Qxua^Xo, Qxua^Xo, Qxua^Xo, Qxua^Xo, Mm^Xm, Mm^Xm, Gll^Ftr, Rb, Rb, Rb, Gs^Ftr, Rb, Gs^Ftr, Rb, Rp, Rp, Gll^Ftr, Rp, Rp, Rp, Wwg, Wwg^Bsb/, 2 Khr, Chr, Wwg, Qxua^Xo, Qxua^Xo, Qxua^Xo, Qxua^Xo, Qxua^Xo, Qxua^Xo, Qxua^Xo
Qxua^Xo, Qxua^Xo, Qxua^Xo, Qxua^Xo, Qxua^Xo, Qxua^Xo, Qxua^Xo, Qxua^Xo, Qxua^Xo, Mm^Xm, Mm^Xm, Mm, Mm, Rb, Gll^Ftr, Rb, Gll^Ftr, Gll^Ftr, Gll^Ftr, Rp, Rb^Gvs, Rb^Gvs, Rb^Gvs, Rp, Gs, Wwg, Qxua^Xo, Chr, Qxua^Xo, Qxua^Xo, Qxua^Xo, Qxua^Xo, Qxua^Xo, Qxua^Xo, Qxua^Xo
Qxua^Xo, Qxua^Xo, Qxua^Xo, Qxua^Xo, Qxua^Xo, Qxua^Xo, Qxua^Xo, Qxua^Xo, Qxua^Xo, Qxua^Xo, Qxua^Xo, Mm, Qxua^Xo, Gll^Ftr, Qxua^Xo, Gll^Ftr, Qxua^Xo, Gll^Ftr, Qxua^Xo, Gll^Ftr, Qxua^Xo, Rb^Gvs, Qxua^Xo, Gs, Qxua^Xo, Qxua^Xo, Qxua^Xo, Qxua^Xo, Qxua^Xo, Qxua^Xo, Qxua^Xo, Qxua^Xo, Qxua^Xo, Qxua^Xo, Qxua^Xo
Qxua^Xo, Qxua^Xo, Qxua^Xo, Qxua^Xo, Qxua^Xo, Qxua^Xo, Qxua^Xo, Qxua^Xo, Qxua^Xo, Qxua^Xo, Qxua^Xo, Qxua^Xo, Qxua^Xo, Qxua^Xo, Qxua^Xo, Qxua^Xo, Qxua^Xo, Qxua^Xo, Qxua^Xo, Qxua^Xo, Qxua^Xo, Qxua^Xo, Qxua^Xo, Qxua^Xo, Qxua^Xo, Qxua^Xo, Qxua^Xo, Qxua^Xo, Qxua^Xo, Qxua^Xo, Qxua^Xo, Qxua^Xo, Qxua^Xo, Qxua^Xo, Qxua^Xo
Qxua^Xo, Qxua^Xo, Qxua^Xo, Qxua^Xo, Qxua^Xo, Qxua^Xo, Qxua^Xo, Qxua^Xo, Qxua^Xo, Qxua^Xo, Qxua^Xo, Qxua^Xo, Qxua^Xo, Qxua^Xo, Qxua^Xo, Qxua^Xo, Qxua^Xo, Qxua^Xo, Qxua^Xo, Qxua^Xo, Qxua^Xo, Qxua^Xo, Qxua^Xo, Qxua^Xo, Qxua^Xo, Qxua^Xo, Qxua^Xo, Qxua^Xo, Qxua^Xo, Qxua^Xo, Qxua^Xo, Qxua^Xo, Qxua^Xo, Qxua^Xo, Qxua^Xo
