border_size=1
usage=map

Qxua^Xo, Qxua^Xo, Qxua^Xo, Qxua^Xo, Qxua^Xo, Qxua^Xo, Qxua^Xo, Qxua^Xo, Qxua^Xo, Qxua^Xo, Qxua^Xo, Qxua^Xo, Qxua^Xo, Qxua^Xo, Qxua^Xo, Qxua^Xo, Qxua^Xo, Qxua^Xo, Qxua^Xo, Qxua^Xo, Qxua^Xo, Qxua^Xo, Qxua^Xo, Qxua^Xo, Qxua^Xo, Qxua^Xo, Qxua^Xo, Qxua^Xo, Qxua^Xo, Qxua^Xo, Qxua^Xo, Qxua^Xo, Qxua^Xo, Qxua^Xo, Qxua^Xo
Qxua^Xo, Qxua^Xo, Qxua^Xo, Qxua^Xo, Qxua^Xo, Qxua^Xo, Qxua^Xo, Qxua^Xo, Qxua^Xo, Qxua^Xo, Qxua^Xo, Qxua^Xo, Qxua^Xo, Qxua^Xo, Qxua^Xo, Qxua^Xo, Qxua^Xo, Qxua^Xo, Qxua^Xo, Qxua^Xo, Qxua^Xo, Qxua^Xo, Qxua^Xo, Qxua^Xo, Qxua^Xo, Qxua^Xo, Qxua^Xo, Qxua^Xo, Qxua^Xo, Qxua^Xo, Qxua^Xo, Qxua^Xo, Qxua^Xo, Qxua^Xo, Qxua^Xo
Qxua^Xo, Qxua^Xo, Qxua^Xo, Qxua^Xo, Qxua^Xo, Qxua^Xo, Qxua^Xo, Qxua^Xo, Qxua^Xo, Qxua^Xo, Ds^Ftp, Dd, Dd, Dd, Dd, Dd^Es, Dd^Es, Dd^Es, Dd, Dd^Es, Dd^Es, Dd, Md, Md, Md^Xm, Qxua^Xo, Qxua^Xo, Qxua^Xo, Qxua^Xo, Qxua^Xo, Qxua^Xo, Qxua^Xo, Qxua^Xo, Qxua^Xo, Qxua^Xo
Qxua^Xo, Qxua^Xo, Qxua^Xo, Qxua^Xo, Qxua^Xo, Qxua^Xo, Qxua^Xo, Chr, Chr, Wwf, Wwf^Bsb/, Rr, Rr, Dd, Rr, Rr, Rr, Dd^Es, Rb, Rb, Rb, Rb, Rb, Md, Rd, Md^Xm, Md^Xm, Qxua^Xo, Qxua^Xo, Qxua^Xo, Qxua^Xo, Qxua^Xo, Qxua^Xo, Qxua^Xo, Qxua^Xo
Qxua^Xo, Qxua^Xo, Qxua^Xo, Qxua^Xo, Khr, Qxua^Xo, Qxua^Xo, Wwf, Wwf, 1 Kh, Wwf, Wwf, Dd^Vh, Rr, Dd, Dd, Dd^Ftp, Rr, Dd, Dd, Dd, Dd, Dd, Rb, Rb, Rd^Fdw, Rd^Fdw, Md^Xm, Md^Xm, Qxua^Xo, Qxua^Xo, Qxua^Xo, Qxua^Xo, Qxua^Xo, Qxua^Xo
Qxua^Xo, Qxua^Xo, Qxua^Xo, Qxua^Xo, Qxua^Xo, Qxua^Xo, Qxua^Xo, Wwf, Rb, Wwf, Rb, Wwf, Wwf, Ds, Ds, Dd, Rb, Rr, Dd, Dd, Dd, Dd, Dd, Hd^Fdw, Hd^Fdw, Rb, Rb, Rd^Fdw, Hd, Md^Xm, Qxua^Xo, Qxua^Xo, Qxua^Xo, Qxua^Xo, Qxua^Xo
Qxua^Xo, Qxua^Xo, Qxua^Xo, Qxua^Xo, Qxua^Xo, Qxua^Xo, Dd, Rb, Dd, Rb, Dd, Ds^Ftp, Ds, Wwf, Wwf^Bw/r, Rb, Ds, Rr, Rr, Dd, Hd, Dd, Dd, Dd, Dd, Rd^Fdw, Ce, Rb, Rb, Md^Xm, Md^Xm, Qxua^Xo, Qxua^Xo, Qxua^Xo, Qxua^Xo
Qxua^Xo, Qxua^Xo, Qxua^Xo, Qxua^Xo, Qxua^Xo, Dd, Dd, Dd, Dd, Dd, Hd, Dd, Rb, Chr, Wwg, Wwg, Wwg, Ds, Ds^Ftp, Rr, Rb, Hd^Fdw, Hd^Fdw, Dd, Dd, Hd^Fdw, Hd, Ke, Rd^Fdw, Rb^Vhs, Md^Xm, Qxua^Xo, Qxua^Xo, Qxua^Xo, Qxua^Xo
Qxua^Xo, Qxua^Xo, Qxua^Xo, Qxua^Xo, Qxua^Xo, Dd, Dd, Dd, Dd, Hd, Dd, Dd, Rb, Ds, Ds^Ftp, Wwg, Wwg, Wwg, Wwg^Bsb/, Rr, Ds, Rb, Hd^Fdw, Dd, Dd, Hd^Fdw, Rb, Rb, Rd, Md^Xm, Qxua^Xo, Qxua^Xo, Qxua^Xo, Qxua^Xo, Qxua^Xo
Qxua^Xo, Qxua^Xo, Qxua^Xo, Qxua^Xo, Qxua^Xo, Dd, Md, Md, Dd, Dd, Rb, Rb, Dd, Rb, Ds, Wwf, Rr^Vhc, Ch, Gs^Ftp, Wwf, Ds, Rb, Hd, Dd, Dd, Rd^Fdw, Rb, Rd^Fdw, Rd^Fdw, Md^Xm, Qxua^Xo, Qxua^Xo, Qxua^Xo, Qxua^Xo, Qxua^Xo
Qxua^Xo, Qxua^Xo, Qxua^Xo, Qxua^Xo, Qxua^Xo, Md^Xm, Rd^Fdw, Md, Rb, Rb, Dd, Dd, Hd, Rb, Ds, Wwf, Gs^Ftp, Kh, Rr^Vhc, Wwf, Ds, Rb, Dd, Dd, Rb, Rb, Dd, Md, Md, Md^Xm, Qxua^Xo, Qxua^Xo, Qxua^Xo, Qxua^Xo, Qxua^Xo
Qxua^Xo, Qxua^Xo, Qxua^Xo, Qxua^Xo, Qxua^Xo, Md^Xm, Rd, Rd^Fdw, Rb, Rd^Fdw, Dd, Dd, Hd^Fdw, Rb, Ds, Wwf, Wwg^Bsb/, Ch, Wwg, Wwf, Ds^Ftp, Rb, Rb, Rb, Dd, Dd, Dd, Md, Dd, Dd, Qxua^Xo, Qxua^Xo, Qxua^Xo, Qxua^Xo, Qxua^Xo
Qxua^Xo, Qxua^Xo, Qxua^Xo, Qxua^Xo, Md^Xm, Md^Xm, Rd^Fdw, Rb, Hd, Hd^Fdw, Dd, Dd, Hd^Fdw, Rb, Rb, Rr, Ds^Ftp, Wwg, Wwg, Wwg, Wwg, Ds, Rb, Dd, Hd, Hd, Dd, Dd, Dd, Dd, Qxua^Xo, Qxua^Xo, Qxua^Xo, Qxua^Xo, Qxua^Xo
Qxua^Xo, Qxua^Xo, Qxua^Xo, Qxua^Xo, Md^Xm, Rb^Vd, Rb, Ke, Ce, Hd^Fdw, Dd, Dd, Dd, Hd^Fdw, Hd, Rr, Rr, Ds, Ds, Wwg, Wwf^Bw/r, Chr, Ds, Dd, Dd, Dd, Dd, Dd, Dd, Dd, Qxua^Xo, Qxua^Xo, Qxua^Xo, Qxua^Xo, Qxua^Xo
Qxua^Xo, Qxua^Xo, Qxua^Xo, Qxua^Xo, Qxua^Xo, Md^Xm, Hd, Rb, Rb, Rd^Fdw, Hd^Fdw, Dd, Dd, Dd, Dd, Dd, Dd, Rr, Rb, Rb, Ds, Wwf, Wwf, Ds^Ftp, Rb, Rb, Rb, Rb, Qxua^Xo, Qxua^Xo, Qxua^Xo, Qxua^Xo, Qxua^Xo, Qxua^Xo, Qxua^Xo
Qxua^Xo, Qxua^Xo, Qxua^Xo, Qxua^Xo, Qxua^Xo, Md^Xm, Md^Xm, Rd^Fdw, Rd^Fdw, Rb, Rb, Hd^Fdw, Dd, Dd, Dd, Dd, Dd, Rr, Dd^Ftp, Dd, Dd, Ds, Dd^Vh, Wwf, Wwf, Wwf, Wwf, Wwf, Qxua^Xo, Qxua^Xo, Khr, Qxua^Xo, Qxua^Xo, Qxua^Xo, Qxua^Xo
Qxua^Xo, Qxua^Xo, Qxua^Xo, Qxua^Xo, Qxua^Xo, Qxua^Xo, Qxua^Xo, Md^Xm, Md^Xm, Rd^Fdw, Rd, Rb, Rb, Dd, Rb, Dd, Rb, Rr, Rr, Dd, Rr, Rr, Rr, Wwf, Wwf^Bsb/, 2 Khr, Chr, Wwf, Qxua^Xo, Qxua^Xo, Qxua^Xo, Qxua^Xo, Qxua^Xo, Qxua^Xo, Qxua^Xo
Qxua^Xo, Qxua^Xo, Qxua^Xo, Qxua^Xo, Qxua^Xo, Qxua^Xo, Qxua^Xo, Qxua^Xo, Qxua^Xo, Md^Xm, Md^Xm, Md, Md, Rb, Dd, Rb, Dd, Dd^Es, Dd, Rr, Dd, Dd, Dd, Rr, Ds^Ftp, Wwf, Qxua^Xo, Chr, Qxua^Xo, Qxua^Xo, Qxua^Xo, Qxua^Xo, Qxua^Xo, Qxua^Xo, Qxua^Xo
Qxua^Xo, Qxua^Xo, Qxua^Xo, Qxua^Xo, Qxua^Xo, Qxua^Xo, Qxua^Xo, Qxua^Xo, Qxua^Xo, Qxua^Xo, Qxua^Xo, Md, Qxua^Xo, Dd^Es, Qxua^Xo, Dd^Es, Qxua^Xo, Dd^Es, Qxua^Xo, Dd^Es, Qxua^Xo, Dd, Qxua^Xo, Dd, Qxua^Xo, Qxua^Xo, Qxua^Xo, Qxua^Xo, Qxua^Xo, Qxua^Xo, Qxua^Xo, Qxua^Xo, Qxua^Xo, Qxua^Xo, Qxua^Xo
Qxua^Xo, Qxua^Xo, Qxua^Xo, Qxua^Xo, Qxua^Xo, Qxua^Xo, Qxua^Xo, Qxua^Xo, Qxua^Xo, Qxua^Xo, Qxua^Xo, Qxua^Xo, Qxua^Xo, Qxua^Xo, Qxua^Xo, Qxua^Xo, Qxua^Xo, Qxua^Xo, Qxua^Xo, Qxua^Xo, Qxua^Xo, Qxua^Xo, Qxua^Xo, Qxua^Xo, Qxua^Xo, Qxua^Xo, Qxua^Xo, Qxua^Xo, Qxua^Xo, Qxua^Xo, Qxua^Xo, Qxua^Xo, Qxua^Xo, Qxua^Xo, Qxua^Xo
Qxua^Xo, Qxua^Xo, Qxua^Xo, Qxua^Xo, Qxua^Xo, Qxua^Xo, Qxua^Xo, Qxua^Xo, Qxua^Xo, Qxua^Xo, Qxua^Xo, Qxua^Xo, Qxua^Xo, Qxua^Xo, Qxua^Xo, Qxua^Xo, Qxua^Xo, Qxua^Xo, Qxua^Xo, Qxua^Xo, Qxua^Xo, Qxua^Xo, Qxua^Xo, Qxua^Xo, Qxua^Xo, Qxua^Xo, Qxua^Xo, Qxua^Xo, Qxua^Xo, Qxua^Xo, Qxua^Xo, Qxua^Xo, Qxua^Xo, Qxua^Xo, Qxua^Xo
