border_size=1
usage=map

Gll^Fp, Gg, Gg, Gg, Rr, Gg, Gll^Fp, Gll^Fp, Gll^Fp, Gll^Fp, Gll^Fp, Gg, Mm, Mm, Mm, Gg, Ms, Gg, Gg, Gg, _off^_usr, _off^_usr, _off^_usr, _off^_usr, _off^_usr, _off^_usr, _off^_usr, _off^_usr, _off^_usr, _off^_usr, _off^_usr, _off^_usr, _off^_usr, _off^_usr, _off^_usr, _off^_usr, _off^_usr, _off^_usr, _off^_usr, _off^_usr, _off^_usr, _off^_usr, _off^_usr, _off^_usr, _off^_usr, _off^_usr, _off^_usr
Gll^Fp, Gg, Gll^Fp, Gll^Fp, Gll^Fp, Rr, Rr, Gll^Fp, Gg, Gll^Fp, Mm, Mm, Mm, Mm, Ms, Ms, Ms, Ms, Ms, Ms, Ms, _off^_usr, _off^_usr, _off^_usr, _off^_usr, _off^_usr, _off^_usr, _off^_usr, _off^_usr, _off^_usr, _off^_usr, _off^_usr, _off^_usr, _off^_usr, _off^_usr, _off^_usr, _off^_usr, _off^_usr, _off^_usr, _off^_usr, _off^_usr, _off^_usr, _off^_usr, _off^_usr, _off^_usr, _off^_usr, _off^_usr
Gg, Gg, Gll^Fp, Gll^Fp, Gll^Fp, Rr, Rr, Mm, Mm, Mm, Ms, Ms, Ms, Ms, Ms^Xm, Ms^Xm, Ms^Xm, Ms, Ms, Ms, Ms, Ms, Ms, _off^_usr, _off^_usr, _off^_usr, _off^_usr, _off^_usr, _off^_usr, _off^_usr, _off^_usr, _off^_usr, _off^_usr, _off^_usr, _off^_usr, _off^_usr, _off^_usr, _off^_usr, _off^_usr, _off^_usr, _off^_usr, _off^_usr, _off^_usr, _off^_usr, _off^_usr, _off^_usr, _off^_usr
Gg, Gg, Gll^Fp, Gg, Mm, Mm, Rr, Mm, Ms, Ms, Ms, Ms, Ms^Xm, Ms^Xm, Mm, Mm, Mm, Ms^Xm, Ms^Xm, Ms, Ms, Ms, Ms, Ms, Ms, _off^_usr, _off^_usr, _off^_usr, _off^_usr, _off^_usr, _off^_usr, _off^_usr, _off^_usr, _off^_usr, _off^_usr, _off^_usr, _off^_usr, _off^_usr, _off^_usr, _off^_usr, _off^_usr, _off^_usr, _off^_usr, _off^_usr, _off^_usr, _off^_usr, _off^_usr
Gll^Fp, Gll^Fp, Gll^Fp, Gll^Fp, Mm, Mm, Rr, Ms, Xos, Ms, Ms^Xm, Ms^Xm, Mm, Mm, Gll^Fp, Mm, Gll^Fp, Mm, Mm, Ms^Xm, Ms^Xm, Ms, Ms^Xm, Ms, Ms, Ms, Ms, _off^_usr, _off^_usr, _off^_usr, _off^_usr, _off^_usr, _off^_usr, _off^_usr, _off^_usr, _off^_usr, _off^_usr, _off^_usr, _off^_usr, _off^_usr, _off^_usr, _off^_usr, _off^_usr, _off^_usr, _off^_usr, _off^_usr, _off^_usr
Gll^Fp, Gll^Fp, Mm, Mm, Ms, Ms, Xos, Rp^Xo, Rp, Ms^Xm, Mm, Mm, Mm, Gll^Fp, Gll^Fp, Mm, Gs^Fp, Gll^Fp, Mm, Mm, Mm, Ms^Xm, Ms^Xm, Ms, Ms, Ms, Ms, Ms, Ms, _off^_usr, _off^_usr, _off^_usr, _off^_usr, _off^_usr, _off^_usr, _off^_usr, _off^_usr, _off^_usr, _off^_usr, _off^_usr, _off^_usr, _off^_usr, _off^_usr, _off^_usr, _off^_usr, _off^_usr, _off^_usr
Gll^Fp, Gll^Fp, Mm, Ms, Ms, Ms, Ms^Xm, Ms^Xm, Mm, Rr, Rr, Mm, Gs^Edt, Gs^Edt, Gs, Gs, Gs, Gd^Edt, Gll^Fp, Mm, Gll^Fp, Mm, Mm, Ms^Xm, Ms^Xm, Ms, Ms, Ms, Ms, Ms, Ms, Ms, Ms, Ms, Ms, _off^_usr, _off^_usr, _off^_usr, _off^_usr, _off^_usr, _off^_usr, _off^_usr, _off^_usr, _off^_usr, _off^_usr, _off^_usr, _off^_usr
Gg, Mm, Mm, Ms, Ms, Ms, Ms^Xm, Ms^Xm, Mm, Gll^Fp, Gll^Fp, Rr, Rr, Gs, Gs, Gs^Es, Gs^Es, Gs^Efm, Gs^Efm, Gll^Fp, Gll^Fp, Mm, Mm, Mm, Mm, Ms^Xm, Ms^Xm, Ms, Ms^Xm, Ms, Ms^Xm, Ms, Ms, Ms, Ms, _off^_usr, _off^_usr, _off^_usr, _off^_usr, _off^_usr, _off^_usr, _off^_usr, _off^_usr, _off^_usr, _off^_usr, _off^_usr, _off^_usr
Mm, Mm, Ms, Ms, Ms, Ms, Ms^Xm, Ms^Xm, Mm, Mm, Gs^Edt, Gs, Gs, Ce, 1 Ke^Xo, Ce, Gs, Gs^Es, Gs^Efm, Gs^Efm, Gs, Mm, Gll^Fp, Gll^Fp, Gll^Fp, Mm, Mm, Ms^Xm, Mm, Ms^Xm, Ms^Xm, Ms^Xm, Ms^Xm, Ms, Ms, Ms, Ms, _off^_usr, _off^_usr, _off^_usr, _off^_usr, _off^_usr, _off^_usr, _off^_usr, _off^_usr, _off^_usr, _off^_usr
Mm, Mm, Ms, Ms, Ms, Ms, Ms^Xm, Ms^Xm, Mm, Gll^Fp, Gll^Fp, Gs, Gs, Ce, Gs, Ce, Rp, Gs^Es, Gs, Gs, Gs^Es, Gll^Fp, Gll^Fp, Gll^Fp, Gll^Fp, Gll^Fp, Mm, Mm, Gll^Fp, Mm, Mm, Mm, Mm, Ms^Xm, Ms, Ms, Ms, _off^_usr, _off^_usr, _off^_usr, _off^_usr, _off^_usr, _off^_usr, _off^_usr, _off^_usr, _off^_usr, _off^_usr
Ms, Ms, Ms, Ms, Ms^Xm, Ms, Ms^Xm, Ms^Xm, Ms^Xm, Mm, Mm, Gs^Efm, Gs^Efm, Gs, Rp, Rp, Gs, Gs, Gs, Gs, Gs, Gs^Es, Gs, Gs, Gs, Gll^Fp, Mm, Mm, Gll^Fp, Gll^Fp, Gll^Fp, Gll^Fp, Mm, Ms^Xm, Ms, Ms, Ms, Ms, _off^_usr, _off^_usr, _off^_usr, _off^_usr, _off^_usr, _off^_usr, _off^_usr, _off^_usr, _off^_usr
Ms, Ms, Ms, Ms^Xm, Wwg, Ms^Xm, Mm, Ms^Xm, Mm, Ms^Xm, Mm, Gs, Gs, Gs, Gs, Rp, Rp, Rp, Rp, Gs^Efm, Gs^Fms, Gs^Es, Rp, Gs, Gs^Efm, Gll^Fp, Gll^Fp, Gll^Fp, Gll^Fp, Gll^Fp, Gll^Fp, Mm, Ms^Xm, Ms^Xm, Ms, Ms, Ms, Ms, Ms, _off^_usr, _off^_usr, _off^_usr, _off^_usr, _off^_usr, _off^_usr, _off^_usr, _off^_usr
Ms, Ms, Ms, Ms^Xm, Ms^Xm, Wwg, Wwg, Mm, Wwg, Mm, Mm, Gs, Wwf, Wwg, Wwg, Gs, Gs, Gs^Fms, Gs, Rp, Rp, Rp, Gs^Wm, Rp, Gs, Gg^Efm, Gs, Gs, Gs, Gll^Fp, Mm, Mm, Ms^Xm, Ms^Xm, Ms^Xm, Ms, Ms, Ms, Ms, Ms, Ms, Ms, Ms, _off^_usr, _off^_usr, _off^_usr, _off^_usr
Ms, Ms, Ms, Ms, Ms^Xm, Mm, Mm, Wwg, Gs, Wwg, Wwg, Wwg, Gs, Gs, Gs, Wwg, Wwg, Gs, Rd, Gs, Rb^Gvs, Rb^Gvs, Rb^Gvs, Rp, Rp, Gs^Efm, Rb^Gvs, Rb^Gvs, Rb^Gvs, Gll^Fp, Mm, Mm, Mm, Mm, Mm, Ms^Xm, Ms^Xm, Ms, Ms, Ms, Ms, Ms, Ms, Ms, Ms, _off^_usr, _off^_usr
Ms, Ms, Ms, Ms, Mm^Xm, Mm^Xm, Gll^Fp, Gll^Fp, Gs^Es, Gs^Es, Rd, Gs, Gs^Es, Hh^Fp, Hh^Fp, Gs, Wwg, Rd, Ce, Ce, Ke^Vov, Rb^Gvs, Ce, Rp, Gs, Rp, Rp, Rb^Gvs, Gs^Vl, Gs, Gs, Gll^Fp, Gll^Fp, Gll^Fp, Gll^Fp, Mm, Ms^Xm, Ms^Xm, Ms^Xm, Ms^Xm, Ms^Xm, Ms, Ms, Ms, Ms, _off^_usr, _off^_usr
Ms, Ms, Ms, Ms^Xm, Mm^Xm, Gll^Fp, Gll^Fp, Gs^Es, Rd, Rd, Gs, Rd, Rd, Gs^Es, Gs, Gs, Wwg^Bw/r, Rd, Rb^Gvs, Rb^Gvs, Rb^Gvs, Ce, Gs, Wwrg, Wwrg, Gs, Gs, Rp, Rp, Gs, Rd, Gs, Gs, Gs, Gs, Mm, Mm, Mm, Mm, Mm, Mm, Ms^Xm, Ms^Xm, Ms, Ms, Ms, Ms
Ms, Ms, Ms, Ms^Xm, Mm^Xm, Gll^Fp, Rd, Rd, Hh^Fp, Mm, Mm^Xm, Gs^Fms, Gs^Fms, Rd, Rd, Rd, Hh, Wwg, Wwg, Rb^Gvs, Gs, Gs, Wwg, Wwg, Wwg, Wwrg, Rb^Gvs, Rb^Gvs, Rb^Gvs, Rp, Gs, Rd, Rd, Rd, Rd, Gs, Mm, Gs, Gll^Fp, Gll^Fp, Gll^Fp, Mm, Ms^Xm, Ms^Xm, Ms, Ms, Ms
Ms, Ms, Ms, Ms^Xm, Mm^Xm, Mm, Rd, Hh, Hhd^Fp, Mm, Mm^Xm, Gs^Fms, Gs^Fms, Gs, Rd, Gs, Gs, Hh^Fp, Ce^Xo, Wwf, Wwg, Wwg, Wo, Wo, Wo^Edt, Wwrg, Wwg, Rb^Gvs, Gs, Rp, Rp, Gs^Fms, Gs^Fms, Gs, Gs^Fms, Rd, Rd, Gs, Gs, Gll^Fp, Mm, Mm, Ms^Xm, Ms, Ms, Ms, Ms
Ms, Ms, Ms^Xm, Ms^Xm, Mm^Xm, Gll^Fpa, Rd, Hh^Fpa, Hhd, Mm^Xm, Mm^Xm, Mm, Gs^Fms, Gs^Fms, Gs^Efm, Rd, Gs^Fms, Gs^Fms, Wwf, Wwf, Wwg, Wwg, Wwg, Wwg, Wwg^Edt, Wo, Wo, Wwg, Wwg, Gs, Rp, Gs^Fms, Gs^Fms, Gs^Fms, Mm^Xm, Mm, Gs, Rd, Mm, Mm^Xm, Mm^Xm, Ms^Xm, Ms^Xm, Ms, Ms, Ms, Ms
Ms, Ms, Ms^Xm, Mm^Xm, Aa^Fpa, Gll^Fpa, Rd, Rd, Aa, Mm, Mm, Mm^Xm, Mm, Gs, Rd, Rd, Rd, Gs^Fms, Wwf^Es, Wwg, Wwg, Wwg, Gs^Fds, Gg, Gll^Fp, Wwg, Wwg, Wo, Wwg^Bsb/, Rp, Rd, Gs, Gs^Fms, Mm, Mm^Xm, Mm, Hh^Fp, Rd, Rd, Hhd, Hhd^Fp, Mm^Xm, Ms^Xm, Ms, Ms, Ms, Ms
Ms^Xm, Ms^Xm, Ms^Xm, Cha^Xo, Rd, Rd, Aa^Fpa, Rd, Aa^Fma, Mm, Mm^Xm, Mm^Xm, Mm^Xm, Gs^Vct, Rd, Gs^Fms, Wwf, Wwf, Wwf, Wwf^Edt, Wwf, Gg, Gs^Fms, Rb^Gvs, Rb^Gvs, Wwg, Wwg^Bsb/, Wo^Bsb/, Wo, Wwg, Gs, Rd, Gs, Mm^Xm, Mm^Xm, Mm, Hhd^Fp, Hh^Fp, Rd, Hhd, Hhd^Fpa, Hhd^Fpa, Mm^Xm, Ms^Xm, Ms^Xm, Ms, Ms^Xm
Ms^Xm, Ms^Xm, Aa^Ecf, Rd, Aa^Fma, Rd, Cea, Rd, Cea, Aa^Fma, Mm^Xm, Ms^Xm, Mm^Xm, Hhd^Fms, Rd, Gs, Wwg, Wwf^Es, Wwf^Es, Wwf, Re, Gg^Efm, Gg, Rp, Rp, Rp, Wwg, Wwg^Es, Wo, Wwg, Gs^Fms, Rd, Rd, Mm, Mm, Mm^Xm, Mm, Hhd, Aa, Rd, Rd, Gll^Fp, Aa^Fpa, Mm^Xm, Mm^Xm, Ms^Xm, Ms^Xm
Ms^Xm, Ms^Xm, Aa^Voa, Rd, Rd, Aa^Fpa, Cea, Kea^Vov, Cea, Aa^Fpa, Mm^Xm, Mm^Xm, Mm^Xm, Hhd^Fms, Rd, Gs^Es, Wwg, Wwg, Wwg, Gg, Gg, Re, Ch, Rp, Ch, Gg, Wwg^Es, Wo, Wo^Edt, Wwg, Wwg, Gs^Es, Rd, Mm, Mm^Xm, Mm^Xm, Mm^Xm, Hhd, Aa, Rd, Aa^Fma, Rd, Rd, Gll^Fp, Ms^Xm, Ms^Xm, Ms^Xm
Ms^Xm, Ms^Xm, Ms^Xm, Aa^Ecf, Rd, Aa^Fpa, Aa^Fma, Rd, Aa, Aa, Mm^Xm, Ms^Xm, Mm^Xm, Gs, Rd, Gs^Es, Wwg, Wot, Wo^Edb, Wwg, Wwg^Es, Gg^Efm, Ch, Kh^Vov, Ch, Gg^Efm, Gg, Wwg, Wwg, Wo, Wwg, Gs^Es, Rd, Gs^Es, Mm^Xm, Ms^Xm, Mm^Xm, Aa, Cea, Rd, Cea, Aa^Fpa, Rd, Aa^Ecf, Rr^Vd, Ms^Xm, Ms^Xm
Ms^Xm, Ms^Xm, Mm^Xm, Gll^Fp, Aa^Fpa, Rd, Rd, Rd, Aa, Hhd, Mm, Mm^Xm, Mm, Mm, Rd, Gs^Es, Gs^Fms, Wwg^Edb, Wo^Edb, Wo, Wwg, Gg, Rp, Rp, Gg, Re, Re, Gg, Wwf, Wwg, Wwg^Edt, Gs^Es, Rd, Hhd^Fms, Mm^Xm, Mm^Xm, Mm^Xm, Aa^Fpa, Cea, Kea^Vov, Cea, Aa^Fpa, Aa^Fma, Rd, Aa^Ecf, Ms^Xm, Ms^Xm
Ms^Xm, Ms^Xm, Ms^Xm, Mm^Xm, Mm^Xm, Gll^Fp, Hhd^Fpa, Rd, Rd, Hhd, Hhd^Fp, Mm^Xm, Mm^Xm, Mm, Gs, Rd, Gs, Wwg, Wo, Wwg, Wwg^Bsb/, Rp, Rb^Gvs, Rp, Gs^Fms, Gg^Efm, Wwf, Wwf, Wwf, Wwf^Es, Wwf, Gs^Es, Rd, Hhd^Fms, Mm^Xm, Ms^Xm, Mm^Xm, Aa^Fma, Aa^Fma, Rd, Aa^Fpa, Rd, Rd, Rd, Ms^Xm, Ms^Xm, Ms^Xm
Ms, Ms, Ms, Ms^Xm, Ms^Xm, Hhd^Fpa, Hhd^Fp, Hhd, Rd, Hh^Fp, Hh^Fp, Mm, Mm^Xm, Mm^Xm, Gs^Fms, Rd, Rd, Wwg, Wwg^Bsb/, Wo^Bsb/, Wwg^Es, Wwg^Es, Gll^Fp, Rb^Gvs, Gs^Fds, Gg, Wwg^Es, Wwf^Edt, Wwf^Es, Wwf, Rd, Gs^Fms, Rd, Gs^Vct, Mm, Mm^Xm, Mm, Mm, Aa, Rd, Rd, Rd, Aa^Fpa, Cha^Xo, Ms^Xm, Ms^Xm, Mm
Ms, Ms, Ms, Ms, Ms^Xm, Mm^Xm, Mm^Xm, Hhd, Mm, Rd, Gs, Mm, Mm^Xm, Mm, Gs^Fms, Gs, Rp, Rp, Wwg, Wo, Wo, Wwg, Wwg, Gg, Wwg, Wwg, Wwg, Wwg, Wwf, Gs^Fms, Gs^Fms, Rd, Gs, Gs, Gs^Fms, Mm^Xm, Mm^Xm, Mm, Hhd, Rd, Rd, Gll^Fpa, Mm^Xm, Mm^Xm, Ms^Xm, Mm, Mm
Ms, Ms, Ms, Ms, Ms^Xm, Ms^Xm, Mm, Mm^Xm, Gs, Rd, Rd, Mm, Gs^Fms, Gs^Fms, Gs^Fms, Gs^Fms, Rp, Gs, Gs, Wwg, Wwg, Wo, Wo, Wwg, Wo^Edt, Wwg, Wwg, Wwf, Ce^Xo, Gs^Fms, Gs, Rd, Rd, Gs^Fms, Gs^Fms, Mm, Mm^Xm, Mm^Xm, Hhd^Fp, Hh^Fpa, Rd, Gll^Fpa, Mm^Xm, Ms^Xm, Mm, Mm, Gll^Fp
Ms, Ms, Ms, Ms, Ms^Xm, Mm, Gll^Fp, Gll^Fp, Gll^Fp, Gs, Mm, Rd, Rd, Gs, Rd, Gs^Fms, Gs, Rp, Rb^Gvs, Rb^Gvs, Rb^Gvs, Wwrg, Wwg, Wo, Wwg, Wwg, Gs, Wwf, Wwg, Hh^Fp, Hh, Gs^Efm, Rd, Gs, Gs^Fms, Gs^Fms, Mm^Xm, Mm, Hh^Fp, Hh, Rd, Mm, Mm^Xm, Ms^Xm, Mm, Gll^Fp, Gll^Fp
Ms, Ms, Ms, Ms^Xm, Ms^Xm, Mm, Mm, Gll^Fp, Mm, Gs, Mm, Gs, Gs^Es, Rd, Gs^Es, Rd, Rd, Rp, Rp, Rb^Gvs, Gs, Wwrg, Wwrg, Wwg, Gs, Gs, Rb^Gvs, Rb^Gvs, Rb^Gvs, Wwg, Wwg^Bw/, Rd, Gs^Es, Rd, Rd, Gs^Fms, Gs, Mm, Rd, Rd, Gll^Fp, Gll^Fp, Mm^Xm, Ms^Xm, Mm, Gll^Fp, Gll^Fp
Ms, Ms, Ms, Ms^Xm, Ms^Xm, Ms^Xm, Ms^Xm, Mm, Ms^Xm, Mm, Ms^Xm, Mm, Gll^Fp, Gs^Es, Gll^Fp, Gs, Gs, Gs, Gs^Vl, Rp, Rp, Gs, Gs, Wwrg, Ce, Ce, Ke^Vov, Rb^Gvs, Ce, Rd, Wwg, Gs, Hh^Fp, Gs^Es, Gs^Es, Rd, Rd, Rd, Gs^Es, Gs^Es, Gll^Fp, Gll^Fp, Mm^Xm, Ms^Xm, Mm, Gll^Fp, Gll^Fp
_off^_usr, Ms, Ms, Ms, Ms, Ms^Xm, Ms, Ms^Xm, Ms^Xm, Ms^Xm, Ms^Xm, Mm, Mm, Gll^Fp, Mm, Gll^Fp, Mm, Gs, Rb^Gvs, Rb^Gvs, Rb^Gvs, Rp, Rp, Rp, Rb^Gvs, Rb^Gvs, Rb^Gvs, Ce, Rd, Rd, Wwg, Gs, Gs, Hh^Fp, Gs, Gs, Wwg, Gs, Gs, Gll^Fp, Mm, Mm^Xm, Ms^Xm, Ms^Xm, Ms^Xm, Mm, Mm
_off^_usr, _off^_usr, _off^_usr, Ms, Ms, Ms, Ms, Ms, Ms, Ms, Ms, Ms^Xm, Ms^Xm, Mm, Ms^Xm, Mm, Mm, Gll^Fp, Gs, Rb^Gvs, Gs, Gs^Efm, Gs^Efm, Rp, Gs^Wm, Rb^Gvs, Rp, Gs, Gs^Efm, Gs, Gs, Wwg, Wwg, Gs, Wwf, Wwg, Mm, Wwg, Wwg, Wwg, Wwg, Mm, Ms^Xm, Ms^Xm, Ms^Xm, Mm, Mm
_off^_usr, _off^_usr, _off^_usr, Ms, Ms, Ms, Ms, Ms, Ms, Ms, Ms, Ms, Ms, Ms^Xm, Ms^Xm, Mm, Gll^Fp, Gll^Fp, Gll^Fp, Gs, Gll^Fp, Gs^Efm, Gs, Rp, Rp, Rp, Gs^Fms, Rp, Rp, Gs^Fms, Rp, Gs, Gs, Wwg, Gs, Gs^Es, Mm, Mm, Mm, Mm, Mm, Wwg, Ms^Xm, Ms^Xm, Mm, Mm, Gg
_off^_usr, _off^_usr, _off^_usr, _off^_usr, _off^_usr, Ms, _off^_usr, Ms, _off^_usr, Ms, Ms, Ms, Ms^Xm, Ms^Xm, Mm, Mm, Gll^Fp, Gll^Fp, Gll^Fp, Gll^Fp, Mm, Gll^Fp, Gs, Gs, Gs, Gs, Gs, Gs, Gs, Rp, Gs, Rp, Rp, Gs, Gs^Efm, Gs^Es, Mm, Ms^Xm, Ms^Xm, Ms^Xm, Ms^Xm, Ms^Xm, Ms, Ms, Ms, Mm, Gg
_off^_usr, _off^_usr, _off^_usr, _off^_usr, _off^_usr, _off^_usr, _off^_usr, _off^_usr, _off^_usr, Ms, Ms, Ms, Ms^Xm, Ms^Xm, Mm, Gll^Fp, Mm, Gll^Fp, Gll^Fp, Mm, Mm, Gll^Fp, Gll^Fp, Gs, Gll^Fp, Gs, Gs, Gs^Es, Gs, Gs, Rp, Rp, Gs, Gs, Gs, Gs^Efm, Gll^Fp, Mm, Mm, Ms^Xm, Ms, Ms, Ms, Ms, Mm, Mm, Gll^Fp
_off^_usr, _off^_usr, _off^_usr, _off^_usr, _off^_usr, _off^_usr, _off^_usr, _off^_usr, _off^_usr, Ms, Ms, Ms, Ms^Xm, Ms^Xm, Ms^Xm, Mm, Ms^Xm, Mm, Mm, Mm, Mm, Gll^Fp, Gll^Fp, Gll^Fp, Gll^Fp, Gll^Fp, Gs, Gs^Efm, Gs^Efm, Gs, Gs, Ce, 2 Ke^Xo, Ce, Gs, Gs^Es, Gs^Edt, Gll^Fp, Mm, Ms^Xm, Ms, Ms, Ms, Mm, Mm, Gll^Fp, Gll^Fp
_off^_usr, _off^_usr, _off^_usr, _off^_usr, _off^_usr, _off^_usr, _off^_usr, _off^_usr, _off^_usr, Ms, Ms, Ms, Ms, Ms^Xm, Ms^Xm, Ms^Xm, Ms^Xm, Ms^Xm, Ms^Xm, Ms^Xm, Ms^Xm, Mm, Mm, Gll^Fp, Mm, Mm, Gll^Fp, Gs^Efm, Gs^Efm, Gg, Gs^Es, Ce, Gs, Ce, Rr, Gs^Es, Gll^Fp, Mm, Mm, Ms^Xm, Ms^Xm, Ms, Ms, Mm, Mm, Gll^Fp, Gll^Fp
_off^_usr, _off^_usr, _off^_usr, _off^_usr, _off^_usr, _off^_usr, _off^_usr, _off^_usr, _off^_usr, Ms, Ms, Ms, Ms, Ms, Ms, Ms, Ms, Ms, Ms, Ms^Xm, Ms^Xm, Ms^Xm, Ms^Xm, Mm, Mm, Mm, Gll^Fp, Gll^Fp, Gll^Fp, Gs^Es, Gs^Es, Gs, Gs, Gs, Gs^Edt, Rr, Rr, Gll^Fp, Mm, Ms^Xm, Ms^Xm, Ms, Mm, Mm, Gg, Gll^Fp, Gg
_off^_usr, _off^_usr, _off^_usr, _off^_usr, _off^_usr, _off^_usr, _off^_usr, _off^_usr, _off^_usr, Ms, Ms, Ms, Ms, Ms, Ms, Ms, Ms, Ms, Ms, Ms, Ms, Ms^Xm, Ms^Xm, Ms^Xm, Ms^Xm, Mm, Mm, Mm, Mm, Gs^Edt, Gll^Fp, Gs, Gll^Fp, Gs^Edt, Mm, Mm, Mm, Rr, Rr, Ms^Xm, Xos, Mm, Gll^Fp, Gll^Fp, Gg, Gll^Fp, Gll^Fp
_off^_usr, _off^_usr, _off^_usr, _off^_usr, _off^_usr, _off^_usr, _off^_usr, _off^_usr, _off^_usr, _off^_usr, _off^_usr, _off^_usr, _off^_usr, Ms, _off^_usr, Ms, _off^_usr, Ms, Ms, Ms, Ms, Ms, Ms, Ms^Xm, Ms, Ms^Xm, Ms^Xm, Mm, Mm, Gll^Fp, Gll^Fp, Mm, Gll^Fp, Gll^Fp, Mm, Mm, Ms^Xm, Ms^Xm, Xos, Rr^Xo, Rp, Mm, Gll^Fp, Gll^Fp, Gg, Gll^Fp, Gll^Fp
_off^_usr, _off^_usr, _off^_usr, _off^_usr, _off^_usr, _off^_usr, _off^_usr, _off^_usr, _off^_usr, _off^_usr, _off^_usr, _off^_usr, _off^_usr, _off^_usr, _off^_usr, _off^_usr, _off^_usr, _off^_usr, _off^_usr, Ms, Ms, Ms, Ms, Ms, Ms, Ms, Ms, Ms^Xm, Ms^Xm, Mm, Mm, Mm, Mm, Mm, Ms^Xm, Ms^Xm, Ms^Xm, Ms^Xm, Mm, Mm, Mm, Rp, Rr, Gg, Gg, Gll^Fp, Gg
_off^_usr, _off^_usr, _off^_usr, _off^_usr, _off^_usr, _off^_usr, _off^_usr, _off^_usr, _off^_usr, _off^_usr, _off^_usr, _off^_usr, _off^_usr, _off^_usr, _off^_usr, _off^_usr, _off^_usr, _off^_usr, _off^_usr, _off^_usr, _off^_usr, _off^_usr, _off^_usr, Ms, _off^_usr, Ms, Ms, Ms, Ms, Ms^Xm, Ms^Xm, Mm, Ms^Xm, Ms^Xm, Ms^Xm, Ms^Xm, Mm, Mm, Mm, Mm, Gll^Fp, Rp, Rr, Gll^Fp, Gll^Fp, Gll^Fp, Gg
_off^_usr, _off^_usr, _off^_usr, _off^_usr, _off^_usr, _off^_usr, _off^_usr, _off^_usr, _off^_usr, _off^_usr, _off^_usr, _off^_usr, _off^_usr, _off^_usr, _off^_usr, _off^_usr, _off^_usr, _off^_usr, _off^_usr, _off^_usr, _off^_usr, _off^_usr, _off^_usr, _off^_usr, _off^_usr, _off^_usr, _off^_usr, Mm, Mm, Ms, Mm, Mm, Mm, Ms, Mm, Mm, Gll^Fp, Mm, Gg, Gll^Fp, Gg, Rp, Rr, Gll^Fp, Gll^Fp, Gll^Fp, Gll^Fp
_off^_usr, _off^_usr, _off^_usr, _off^_usr, _off^_usr, _off^_usr, _off^_usr, _off^_usr, _off^_usr, _off^_usr, _off^_usr, _off^_usr, _off^_usr, _off^_usr, _off^_usr, _off^_usr, _off^_usr, _off^_usr, _off^_usr, _off^_usr, _off^_usr, _off^_usr, _off^_usr, _off^_usr, _off^_usr, _off^_usr, _off^_usr, _off^_usr, _off^_usr, Mm, Mm, Mm, Mm, Mm, Gll^Fp, Gll^Fp, Gll^Fp, Gll^Fp, Gll^Fp, Gll^Fp, Gg, Rp, Rp, Gll^Fp, Gll^Fp, Gll^Fp, Gll^Fp
_off^_usr, _off^_usr, _off^_usr, _off^_usr, _off^_usr, _off^_usr, _off^_usr, _off^_usr, _off^_usr, _off^_usr, _off^_usr, _off^_usr, _off^_usr, _off^_usr, _off^_usr, _off^_usr, _off^_usr, _off^_usr, _off^_usr, _off^_usr, _off^_usr, _off^_usr, _off^_usr, _off^_usr, _off^_usr, _off^_usr, _off^_usr, _off^_usr, _off^_usr, _off^_usr, Gg, Mm, Gg, Gg, Gg, Gg, Gg, Gll^Fp, Gll^Fp, Gll^Fp, Gll^Fp, Gll^Fp, Gg, Rp, Gg, Gll^Fp, Gg
