border_size=1
usage=map

Qxua^Xo, Qxua^Xo, Qxua^Xo, Qxua^Xo, Qxua^Xo, Qxua^Xo, Qxua^Xo, Qxua^Xo, Qxua^Xo, Qxua^Xo, Qxua^Xo, Qxua^Xo, Qxua^Xo, Qxua^Xo, Qxua^Xo, Qxua^Xo, Qxua^Xo, Qxua^Xo, Qxua^Xo, Qxua^Xo, Qxua^Xo, Qxua^Xo, Qxua^Xo, Qxua^Xo, Qxua^Xo, Qxua^Xo, Qxua^Xo, Qxua^Xo, Qxua^Xo, Qxua^Xo, Qxua^Xo, Qxua^Xo, Qxua^Xo, Qxua^Xo, Qxua^Xo, Qxua^Xo
Qxua^Xo, Qxua^Xo, Qxua^Xo, Qxua^Xo, Qxua^Xo, Qxua^Xo, Qxua^Xo, Qxua^Xo, Qxua^Xo, Qxua^Xo, Qxua^Xo, Qxua^Xo, Qxua^Xo, Qxua^Xo, Qxua^Xo, Qxua^Xo, Qxua^Xo, Qxua^Xo, Qxua^Xo, Qxua^Xo, Qxua^Xo, Qxua^Xo, Qxua^Xo, Qxua^Xo, Qxua^Xo, Qxua^Xo, Qxua^Xo, Qxua^Xo, Qxua^Xo, Qxua^Xo, Qxua^Xo, Qxua^Xo, Qxua^Xo, Qxua^Xo, Qxua^Xo, Qxua^Xo
Qxua^Xo, Qxua^Xo, Qxua^Xo, Qxua^Xo, Qxua^Xo, Qxua^Xo, Qxua^Xo, Qxua^Xo, Qxua^Xo, Qxua^Xo, Uu, Uu, Uu, Uu, Uu, Uu^Es, Uu^Es, Uu^Es, Uu, Uu^Es, Uu^Es, Uu, Md, Md, Md^Xm, Qxua^Xo, Qxua^Xo, Qxua^Xo, Qxua^Xo, Qxua^Xo, Qxua^Xo, Qxua^Xo, Qxua^Xo, Qxua^Xo, Qxua^Xo, Qxua^Xo
Qxua^Xo, Qxua^Xo, Qxua^Xo, Qxua^Xo, Qxua^Xo, Qxua^Xo, Qxua^Xo, Chr, Chr, Wwg, Wwg^Bsb/, Urb, Urb, Uu, Urb, Urb, Urb, Uu^Es, Ur, Ur, Ur, Ur, Ur, Md, Uu, Md^Xm, Md^Xm, Qxua^Xo, Qxua^Xo, Qxua^Xo, Qxua^Xo, Qxua^Xo, Qxua^Xo, Qxua^Xo, Qxua^Xo, Qxua^Xo
Qxua^Xo, Qxua^Xo, Qxua^Xo, Qxua^Xo, Qxua^Xo, Qxua^Xo, Qxua^Xo, Wwg, Wwg, 1 Kh, Wwg, Wwg, Uu^Vh, Urb, Uh, Uh, Uh, Urb, Uu, Uu^Uf, Uu^Uf, Uu^Uf, Uu^Uf, Ur, Ur, Uu^Fpa, Uu^Fpa, Md^Xm, Md^Xm, Qxua^Xo, Qxua^Xo, Qxua^Xo, Qxua^Xo, Qxua^Xo, Qxua^Xo, Qxua^Xo
Qxua^Xo, Qxua^Xo, Qxua^Xo, Qxua^Xo, Qxua^Xo, Qxua^Xo, Qxua^Xo, Wwg, Ss, Wwg, Ss, Wwg, Wwg, Uu, Uu, Uu, Rb, Urb, Uu, Uu^Uf, Uu^Uf, Sm, Sm, Uh^Uf, Uh^Uf, Ur, Ur, Uu^Fpa, Uh, Md^Xm, Qxua^Xo, Qxua^Xo, Qxua^Xo, Qxua^Xo, Qxua^Xo, Qxua^Xo
Qxua^Xo, Qxua^Xo, Qxua^Xo, Qxua^Xo, Qxua^Xo, Qxua^Xo, Uu^Uf, Ss, Uu^Uf, Ss, Uu, Uu, Uu, Wwg, Wwg^Bw/r, Rb, Uu, Urb, Urb, Uu, Uh, Sm, Sm, Sm, Sm, Uu^Uf, Cea, Ur, Ur, Md^Xm, Md^Xm, Qxua^Xo, Qxua^Xo, Qxua^Xo, Qxua^Xo, Qxua^Xo
Qxua^Xo, Qxua^Xo, Qxua^Xo, Qxua^Xo, Qxua^Xo, Uu^Uf, Uu^Uf, Uu^Uf, Uu^Uf, Uu^Uf, Md, Uu, Rb, Chr, Wog, Wog, Wog, Uu, Uu, Urb, Ur, Uh^Uf, Uh^Uf, Sm, Sm, Uh^Uf, Uh, Kea, Uu^Fpa, Rb^Vhs, Md^Xm, Qxua^Xo, Qxua^Xo, Qxua^Xo, Qxua^Xo, Qxua^Xo
Qxua^Xo, Qxua^Xo, Qxua^Xo, Qxua^Xo, Qxua^Xo, Uu^Uf, Uu^Uf, Uu^Uf, Uu^Uf, Md, Uu, Uu, Rb, Uu, Uu, Wog, Wog, Wog, Wog^Bsb/, Urb, Uu, Ur, Uh^Uf, Sm, Sm, Uh^Uf, Ur, Ur, Uu, Md^Xm, Qxua^Xo, Qxua^Xo, Qxua^Xo, Qxua^Xo, Qxua^Xo, Qxua^Xo
Qxua^Xo, Qxua^Xo, Qxua^Xo, Qxua^Xo, Qxua^Xo, Uu^Uf, Md, Md, Uu^Uf, Uu^Uf, Rb, Rb, Uu, Rb, Ss, Wog, Urb^Vhc, Ch, Urb^Uf, Wog, Ss, Ur, Uh, Sm, Uu, Uu^Uf, Ur, Uu^Fpa, Uu^Fpa, Md^Xm, Qxua^Xo, Qxua^Xo, Qxua^Xo, Qxua^Xo, Qxua^Xo, Qxua^Xo
Qxua^Xo, Qxua^Xo, Qxua^Xo, Qxua^Xo, Qxua^Xo, Md^Xm, Uu^Fpa, Md, Rb, Rb, Uu, Uu, Uh, Rb, Ss, Wog, Urb^Uf, Kh, Urb^Vhc, Wog, Ss, Ur, Uu, Uu, Ur, Ur, Uu^Uf, Md, Md, Md^Xm, Qxua^Xo, Qxua^Xo, Qxua^Xo, Qxua^Xo, Qxua^Xo, Qxua^Xo
Qxua^Xo, Qxua^Xo, Qxua^Xo, Qxua^Xo, Qxua^Xo, Md^Xm, Uu, Uu^Fpa, Rb, Uu^Uf, Sm, Sm, Uh^Uf, Rb, Uu, Wog, Wog^Bsb/, Ch, Wog, Wog, Uu, Ur, Ur, Ur, Uu, Uu^Uf, Uu^Uf, Md, Uu^Uf, Uu^Uf, Qxua^Xo, Qxua^Xo, Qxua^Xo, Qxua^Xo, Qxua^Xo, Qxua^Xo
Qxua^Xo, Qxua^Xo, Qxua^Xo, Qxua^Xo, Md^Xm, Md^Xm, Uu^Fpa, Rb, Uh, Uh^Uf, Sm, Sm, Uh^Uf, Rb, Rb, Urb, Uu, Wog, Wog, Wog, Wog, Uu, Ur, Uu, Md, Md, Uu^Uf, Uu^Uf, Uu^Uf, Uu^Uf, Qxua^Xo, Qxua^Xo, Qxua^Xo, Qxua^Xo, Qxua^Xo, Qxua^Xo
Qxua^Xo, Qxua^Xo, Qxua^Xo, Qxua^Xo, Md^Xm, Rb^Vd, Ur, Kea, Cea, Uh^Uf, Sm, Sm, Sm, Uh^Uf, Uh, Urb, Urb, Uu, Uu, Wog, Wwg^Bw/r, Chr, Uu, Uu, Uu, Uu^Uf, Uu^Uf, Uu^Uf, Uu^Uf, Uu^Uf, Qxua^Xo, Qxua^Xo, Qxua^Xo, Qxua^Xo, Qxua^Xo, Qxua^Xo
Qxua^Xo, Qxua^Xo, Qxua^Xo, Qxua^Xo, Qxua^Xo, Md^Xm, Uh, Ur, Ur, Uu^Uf, Uh^Uf, Sm, Sm, Sm, Uu^Uf, Uu, Uu, Urb, Ur, Ur, Uu, Wwg, Wwg, Uu, Ss, Ss, Ss, Ss, Qxua^Xo, Qxua^Xo, Qxua^Xo, Qxua^Xo, Qxua^Xo, Qxua^Xo, Qxua^Xo, Qxua^Xo
Qxua^Xo, Qxua^Xo, Qxua^Xo, Qxua^Xo, Qxua^Xo, Md^Xm, Md^Xm, Uu^Fpa, Uu^Fpa, Ur, Ur, Uh^Uf, Uu^Uf, Sm, Uu^Uf, Uu^Uf, Uu, Urb, Uu, Uh, Uh, Uu, Uu^Vh, Wwg, Wwg, Wwg, Wwg, Wwg, Qxua^Xo, Qxua^Xo, Qxua^Xo, Qxua^Xo, Qxua^Xo, Qxua^Xo, Qxua^Xo, Qxua^Xo
Qxua^Xo, Qxua^Xo, Qxua^Xo, Qxua^Xo, Qxua^Xo, Qxua^Xo, Qxua^Xo, Md^Xm, Md^Xm, Uu^Fpa, Uu, Ur, Ur, Uu^Uf, Ur, Uu^Uf, Ur, Urb, Urb, Uh, Urb, Urb, Urb, Wwg, Wwg^Bsb/, 2 Khr, Chr, Wwg, Qxua^Xo, Qxua^Xo, Qxua^Xo, Qxua^Xo, Qxua^Xo, Qxua^Xo, Qxua^Xo, Qxua^Xo
Qxua^Xo, Qxua^Xo, Qxua^Xo, Qxua^Xo, Qxua^Xo, Qxua^Xo, Qxua^Xo, Qxua^Xo, Qxua^Xo, Md^Xm, Md^Xm, Md, Md, Ur, Uu, Ur, Uu, Uu^Es, Uu, Urb, Uu, Uu, Uu, Urb, Uu, Wwg, Qxua^Xo, Chr, Qxua^Xo, Qxua^Xo, Qxua^Xo, Qxua^Xo, Qxua^Xo, Qxua^Xo, Qxua^Xo, Qxua^Xo
Qxua^Xo, Qxua^Xo, Qxua^Xo, Qxua^Xo, Qxua^Xo, Qxua^Xo, Qxua^Xo, Qxua^Xo, Qxua^Xo, Qxua^Xo, Qxua^Xo, Md, Qxua^Xo, Uu^Es, Qxua^Xo, Uu^Es, Qxua^Xo, Uu^Es, Qxua^Xo, Uu^Es, Qxua^Xo, Uu, Qxua^Xo, Uu, Qxua^Xo, Qxua^Xo, Qxua^Xo, Qxua^Xo, Qxua^Xo, Qxua^Xo, Qxua^Xo, Qxua^Xo, Qxua^Xo, Qxua^Xo, Qxua^Xo, Qxua^Xo
Qxua^Xo, Qxua^Xo, Qxua^Xo, Qxua^Xo, Qxua^Xo, Qxua^Xo, Qxua^Xo, Qxua^Xo, Qxua^Xo, Qxua^Xo, Qxua^Xo, Qxua^Xo, Qxua^Xo, Qxua^Xo, Qxua^Xo, Qxua^Xo, Qxua^Xo, Qxua^Xo, Qxua^Xo, Qxua^Xo, Qxua^Xo, Qxua^Xo, Qxua^Xo, Qxua^Xo, Qxua^Xo, Qxua^Xo, Qxua^Xo, Qxua^Xo, Qxua^Xo, Qxua^Xo, Qxua^Xo, Qxua^Xo, Qxua^Xo, Qxua^Xo, Qxua^Xo, Qxua^Xo
Qxua^Xo, Qxua^Xo, Qxua^Xo, Qxua^Xo, Qxua^Xo, Qxua^Xo, Qxua^Xo, Qxua^Xo, Qxua^Xo, Qxua^Xo, Qxua^Xo, Qxua^Xo, Qxua^Xo, Qxua^Xo, Qxua^Xo, Qxua^Xo, Qxua^Xo, Qxua^Xo, Qxua^Xo, Qxua^Xo, Qxua^Xo, Qxua^Xo, Qxua^Xo, Qxua^Xo, Qxua^Xo, Qxua^Xo, Qxua^Xo, Qxua^Xo, Qxua^Xo, Qxua^Xo, Qxua^Xo, Qxua^Xo, Qxua^Xo, Qxua^Xo, Qxua^Xo, Qxua^Xo
