border_size=1
usage=map

Qxua^Xo, Qxua^Xo, Qxua^Xo, Qxua^Xo, Qxua^Xo, Qxua^Xo, Qxua^Xo, Qxua^Xo, Qxua^Xo, Qxua^Xo, Qxua^Xo, Qxua^Xo, Qxua^Xo, Qxua^Xo, Qxua^Xo, Qxua^Xo, Qxua^Xo, Qxua^Xo, Qxua^Xo, Qxua^Xo, Qxua^Xo, Qxua^Xo, Qxua^Xo, Qxua^Xo, Qxua^Xo, Qxua^Xo, Qxua^Xo, Qxua^Xo, Qxua^Xo, Qxua^Xo, Qxua^Xo, Qxua, Qxua^Xo, Qxua^Xo, Qxua^Xo
Qxua^Xo, Qxua^Xo, Qxua^Xo, Qxua^Xo, Qxua^Xo, Qxua^Xo, Qxua^Xo, Qxua^Xo, Qxua^Xo, Qxua^Xo, Qxua^Xo, Qxua^Xo, Qxua^Xo, Qxua^Xo, Qxua^Xo, Qxua^Xo, Qxua^Xo, Qxua^Xo, Qxua^Xo, Qxua^Xo, Qxua^Xo, Qxua^Xo, Qxua^Xo, Qxua^Xo, Qxua^Xo, Qxua^Xo, Qxua^Xo, Qxua^Xo, Qxua^Xo, Qxua^Xo, Qxua^Xo, Qxua^Xo, Qxua^Xo, Qxua^Xo, Qxua^Xo
Qxua^Xo, Qxua^Xo, Qxua^Xo, Qxua^Xo, Qxua^Xo, Qxua^Xo, Qxua^Xo, Qxua^Xo, Qxua^Xo, Qxua^Xo, Gd, Gd, Gd^Gvs, Gd, Gd, Gd^Es, Gd^Es, Gd^Es, Gd, Gd^Es, Gd^Es, Gd, Md, Md, Ms^Xm, Qxua^Xo, Qxua^Xo, Qxua^Xo, Qxua^Xo, Qxua^Xo, Qxua^Xo, Qxua^Xo, Qxua^Xo, Qxua^Xo, Qxua^Xo
Qxua^Xo, Qxua^Xo, Qxua^Xo, Qxua^Xo, Qxua^Xo, Qxua^Xo, Qxua^Xo, Chr, Chr, Wwf, Wwf^Bsb/, Rp, Rp, Gd^Es, Rp, Rp, Rp, Gd^Es, Rb, Rb, Rb, Rb, Rb, Md, Aa, Ms^Xm, Ms^Xm, Qxua^Xo, Qxua^Xo, Qxua^Xo, Qxua^Xo, Qxua^Xo, Qxua^Xo, Qxua^Xo, Qxua^Xo
Qxua^Xo, Qxua^Xo, Qxua^Xo, Qxua^Xo, Khr, Qxua^Xo, Qxua^Xo, Wwf, Wwf, 1 Kh, Wwf, Wwf, Gd^Vh, Rp, Gd^Es, Gd^Es, Gd^Es, Rp, Gd, Gd^Fdw, Gd^Fdw, Gd^Fdw, Gd^Fdw, Rb, Rb, Aa^Fpa, Aa^Fpa, Ms^Xm, Ms^Xm, Qxua^Xo, Qxua^Xo, Qxua^Xo, Qxua^Xo, Qxua^Xo, Qxua^Xo
Qxua^Xo, Qxua^Xo, Qxua^Xo, Qxua^Xo, Qxua^Xo, Qxua^Xo, Qxua^Xo, Wwf, Rb, Wwf, Rb, Wwf, Wwf, Gd^Gvs, Gd^Gvs, Gd^Es, Rb, Rp, Gd, Gd^Fdw, Gd^Fdw, Mm, Ms, Ha^Fpa, Ha^Fpa, Rb, Rb, Aa^Fpa, Ha, Ms^Xm, Qxua^Xo, Qxua^Xo, Qxua^Xo, Qxua^Xo, Qxua^Xo
Qxua^Xo, Qxua^Xo, Qxua^Xo, Qxua^Xo, Qxua^Xo, Qxua^Xo, Gd^Fdw, Rb, Gd^Fdw, Rb, Gd, Gd^Es, Gd^Es, Wwf, Wwf^Bw/r, Rb, Gd, Rp, Rp, Gd, Hhd, Md, Md, Ms, Ms, Aa^Fpa, Cea, Rb, Rb, Ms^Xm, Ms^Xm, Qxua^Xo, Qxua^Xo, Qxua^Xo, Qxua^Xo
Qxua^Xo, Qxua^Xo, Qxua^Xo, Qxua^Xo, Qxua^Xo, Gd^Fdw, Gd^Fdw, Gd^Fdw, Gd^Fdw, Gd^Fdw, Md, Gd, Rb, Chr, Wwg, Wwg, Wwg, Gd^Es, Gd^Es, Rp, Rb, Hhd^Fdw, Hhd^Fdw, Md, Ms, Ha^Fpa, Ha, Kea, Aa^Fpa, Rb^Vhs, Ms^Xm, Qxua^Xo, Qxua^Xo, Qxua^Xo, Qxua^Xo
Qxua^Xo, Qxua^Xo, Qxua^Xo, Qxua^Xo, Qxua^Xo, Gd^Fdw, Gd^Fdw, Gd^Fdw, Gd^Fdw, Md, Gd^Es, Gd^Es, Rb, Gd^Es, Gd^Es, Wwg, Wwg, Wwg, Wwg^Bsb/, Rp, Gd, Rb, Hhd^Fdw, Md, Md, Ha^Fpa, Rb, Rb, Aa, Ms^Xm, Qxua^Xo, Qxua^Xo, Qxua^Xo, Qxua^Xo, Qxua^Xo
Qxua^Xo, Qxua^Xo, Qxua^Xo, Qxua^Xo, Qxua^Xo, Gd^Fdw, Md, Md, Gd^Fdw, Gd^Fdw, Rb, Rb, Gd, Rb, Rb, Wwf, Rr^Vhc, Ch, Gd^Fdw, Wwf, Rb, Rb, Hhd, Md, Gd^Es, Aa^Fpa, Rb, Aa^Fpa, Aa^Fpa, Ms^Xm, Qxua^Xo, Qxua^Xo, Qxua^Xo, Qxua^Xo, Qxua^Xo
Qxua^Xo, Qxua^Xo, Qxua^Xo, Qxua^Xo, Qxua^Xo, Ms^Xm, Aa^Fpa, Md, Rb, Rb, Gd^Es, Gd, Hhd, Rb, Rb, Wwf, Gd^Fdw, Kh, Rr^Vhc, Wwf, Rb, Rb, Gd, Gd, Rb, Rb, Gd^Fdw, Md, Md, Ms^Xm, Qxua^Xo, Qxua^Xo, Qxua^Xo, Qxua^Xo, Qxua^Xo
Qxua^Xo, Qxua^Xo, Qxua^Xo, Qxua^Xo, Qxua^Xo, Ms^Xm, Aa, Aa^Fpa, Rb, Aa^Fpa, Mm, Md, Hhd^Fdw, Rb, Gd, Wwf, Wwg^Bsb/, Ch, Wwg, Wwf, Gd^Es, Rb, Rb, Rb, Gd^Es, Gd^Fdw, Gd^Fdw, Md, Gd^Fdw, Gd^Fdw, Qxua^Xo, Qxua^Xo, Qxua^Xo, Qxua^Xo, Qxua^Xo
Qxua^Xo, Qxua^Xo, Qxua^Xo, Qxua^Xo, Ms^Xm, Ms^Xm, Aa^Fpa, Rb, Ha, Ha^Fpa, Ms, Md, Hhd^Fdw, Rb, Rb, Rp, Gd, Wwg, Wwg, Wwg, Wwg, Gd^Es, Rb, Gd^Es, Md, Md, Gd^Fdw, Gd^Fdw, Gd^Fdw, Gd^Fdw, Qxua^Xo, Qxua^Xo, Qxua^Xo, Qxua^Xo, Qxua^Xo
Qxua^Xo, Qxua^Xo, Qxua^Xo, Qxua^Xo, Ms^Xm, Rb^Vd, Rb, Kea, Cea, Ha^Fpa, Ms, Md, Md, Hhd^Fdw, Hhd, Rp, Rp, Gd^Es, Gd^Es, Wwg, Wwf^Bw/r, Chr, Gd^Es, Gd, Gd, Gd^Fdw, Gd^Fdw, Gd^Fdw, Gd^Fdw, Gd^Fdw, Qxua^Xo, Qxua^Xo, Qxua^Xo, Qxua^Xo, Qxua^Xo
Qxua^Xo, Qxua^Xo, Qxua^Xo, Qxua^Xo, Qxua^Xo, Ms^Xm, Ha, Rb, Rb, Aa^Fpa, Ha^Fpa, Ms, Ms, Md, Gd^Fdw, Gd, Gd, Rp, Rb, Rb, Gd^Gvs, Wwf, Wwf, Gd^Es, Rb, Rb, Rb, Rb, Qxua^Xo, Qxua^Xo, Qxua^Xo, Qxua^Xo, Qxua^Xo, Qxua^Xo, Qxua^Xo
Qxua^Xo, Qxua^Xo, Qxua^Xo, Qxua^Xo, Qxua^Xo, Ms^Xm, Ms^Xm, Aa^Fpa, Aa^Fpa, Rb, Rb, Ha^Fpa, Gd^Fdw, Mm, Gd^Fdw, Gd^Fdw, Gd, Rp, Gd^Es, Gd^Es, Gd^Es, Gd^Gvs, Gd^Vh, Wwf, Wwf, Wwf, Wwf, Wwf, Qxua^Xo, Qxua^Xo, Khr, Qxua^Xo, Qxua^Xo, Qxua^Xo, Qxua^Xo
Qxua^Xo, Qxua^Xo, Qxua^Xo, Qxua^Xo, Qxua^Xo, Qxua^Xo, Qxua^Xo, Ms^Xm, Ms^Xm, Aa^Fpa, Aa, Rb, Rb, Gd^Fdw, Rb, Gd^Fdw, Rb, Rp, Rp, Gd^Es, Rp, Rp, Rp, Wwf, Wwf^Bsb/, 2 Khr, Chr, Wwf, Qxua^Xo, Qxua^Xo, Qxua^Xo, Qxua^Xo, Qxua^Xo, Qxua^Xo, Qxua^Xo
Qxua^Xo, Qxua^Xo, Qxua^Xo, Qxua^Xo, Qxua^Xo, Qxua^Xo, Qxua^Xo, Qxua^Xo, Qxua^Xo, Ms^Xm, Ms^Xm, Md, Md, Rb, Gd, Rb, Gd, Gd^Es, Gd, Rp, Gd, Gd^Es, Gd^Gvs, Rp, Gd, Wwf, Qxua^Xo, Chr, Qxua^Xo, Qxua^Xo, Qxua^Xo, Qxua^Xo, Qxua^Xo, Qxua^Xo, Qxua^Xo
Qxua^Xo, Qxua^Xo, Qxua^Xo, Qxua^Xo, Qxua^Xo, Qxua^Xo, Qxua^Xo, Qxua^Xo, Qxua^Xo, Qxua^Xo, Qxua^Xo, Md, Qxua^Xo, Gd^Es, Qxua^Xo, Gd^Es, Qxua^Xo, Gd^Es, Qxua^Xo, Gd^Es, Qxua^Xo, Gd, Qxua^Xo, Gd, Qxua^Xo, Qxua^Xo, Qxua^Xo, Qxua^Xo, Qxua^Xo, Qxua^Xo, Qxua^Xo, Qxua^Xo, Qxua^Xo, Qxua^Xo, Qxua^Xo
Qxua^Xo, Qxua^Xo, Qxua^Xo, Qxua^Xo, Qxua^Xo, Qxua^Xo, Qxua^Xo, Qxua^Xo, Qxua^Xo, Qxua^Xo, Qxua^Xo, Qxua^Xo, Qxua^Xo, Qxua^Xo, Qxua^Xo, Qxua^Xo, Qxua^Xo, Qxua^Xo, Qxua^Xo, Qxua^Xo, Qxua^Xo, Qxua^Xo, Qxua^Xo, Qxua^Xo, Qxua^Xo, Qxua^Xo, Qxua^Xo, Qxua^Xo, Qxua^Xo, Qxua^Xo, Qxua^Xo, Qxua^Xo, Qxua^Xo, Qxua^Xo, Qxua^Xo
Qxua^Xo, Qxua^Xo, Qxua^Xo, Qxua^Xo, Qxua^Xo, Qxua^Xo, Qxua^Xo, Qxua^Xo, Qxua^Xo, Qxua^Xo, Qxua^Xo, Qxua^Xo, Qxua^Xo, Qxua^Xo, Qxua^Xo, Qxua^Xo, Qxua^Xo, Qxua^Xo, Qxua^Xo, Qxua^Xo, Qxua^Xo, Qxua^Xo, Qxua^Xo, Qxua^Xo, Qxua^Xo, Qxua^Xo, Qxua^Xo, Qxua^Xo, Qxua^Xo, Qxua^Xo, Qxua^Xo, Qxua^Xo, Qxua^Xo, Qxua^Xo, Qxua^Xo
